
||||||||||||||||||||||||||||
|..........................|
|.|||||||.||||||||.|||||||.|
|.|||||||.||||||||.|||||||.|
|.........||||||||.........|
|.|||||||.||||||||.|||||||.|
|.|||||||.||||||||.|||||||.|
|.|||||||....||....|||||||.|
|.|||||||.||....||.|||||||.|
|.........||||||||.........|
|.|||||||.||||||||.|||||||.|
|.|||||||..........|||||||.|
|.........||||||||.........|
|.|||.|||.||||||||.|||.|||.|
|.|||.|||.||||||||.|||.|||.|
|.|||..||.||||||||.||..|||.|
|.||||.||.||||||||.||.||||.|
|.||||................||||.|
|......||.|||..|||.||......|
|.||||.||.|||..|||.||.||||.|
|.||||.||.|||..|||.||.||||.|
|.||||.||.|||..|||.||.||||.|
|.||||.||.|||..|||.||.||||.|
|......||.|||..|||.||......|
|.||||......||||......||||.|
|.|||||.|||.||||.|||.|||||.|
|....||.|||......|||.||....|
|.|||||.||||.||.||||.|||||.|
|.|||||.||||.||.||||.|||||.|
|..........................|
||||||||||||||||||||||||||||
