
||||||||||||||||||||||||||||
|..........................|
|.||.||||.||||||||.||||.||.|
|.||.||||.||||||||.||||.||.|
|.||.||||.||||||||.||||.||.|
|.||.||||..........||||.||.|
|.........||||||||.........|
|.|||.|||.||||||||.|||.|||.|
|.|||.|||....||....|||.|||.|
|.|||.|||.||.||.||.|||.|||.|
|.|||.||..||.||.||..||.|||.|
|.|||.|||..........|||.|||.|
|.|||.|||.||||||||.|||.|||.|
|.|||.....||||||||.....|||.|
|.|||.|||.||||||||.|||.|||.|
|.....|||.||||||||.|||.....|
|.|||.|||.||||||||.|||.|||.|
|.|||.|||..........|||.|||.|
|.|||.....||||||||.....|||.|
|.|||.||.||||||||||.||.|||.|
|.....||.||||||||||.||.....|
|.|||.||.||||||||||.||.|||.|
|.|||.||............||.|||.|
|.....||.||.||||.||.||.....|
|.|||.||.||.||||.||.||.|||.|
|.|||....||.||||.||....|||.|
|.|||.||.||.||||.||.||.|||.|
|.|||.||.||.||||.||.||.|||.|
|.|||.||.||.||||.||.||.|||.|
|..........................|
||||||||||||||||||||||||||||
