
||||||||||||||||||||||||||||
|..........................|
|.||||||.|||.||.|||.||||||.|
|.||||||.|||.||.|||.||||||.|
|.||||||.....||.....||||||.|
|........||||||||||........|
|.||||||.||||||||||.||||||.|
|.||||||.....||.....||||||.|
|.||||||.|||.||.|||.||||||.|
|.||||||.|||.||.|||.||||||.|
|.........||.||.||.........|
|.||.||||..........||||.||.|
|.||.||||.||||||||.||||.||.|
|.||.||||.||||||||.||||.||.|
|.||.||||.||||||||.||||.||.|
|.||.||||.||||||||.||||.||.|
|.||.||||.||||||||.||||.||.|
|..........................|
|.||||.|||.||||||.|||.||||.|
|.||||.|||.||||||.|||.||||.|
|.||||.|||.||||||.|||.||||.|
|.||||................||||.|
|.||||.||.||||||||.||.||||.|
|.||||.||||||||||||||.||||.|
|........|||....|||........|
|.|||.||.....||.....||.|||.|
|.|||.||||.||||||.||||.|||.|
|.|||.||||.||||||.||||.|||.|
|.|||.||||.||||||.||||.|||.|
|..........................|
||||||||||||||||||||||||||||
