
||||||||||||||||||||||||||||
|..........................|
|.||.||.||.||||||.||.||.||.|
|.||.||.||.||||||.||.||.||.|
|.||.||.||.||||||.||.||.||.|
|.||.||.||...||...||.||.||.|
|.||.||.||||.||.||||.||.||.|
|.||.||.||||.||.||||.||.||.|
|.||.||.||||....||||.||.||.|
|.||......||.||.||......||.|
|.|||.|||.||.||.||.|||.|||.|
|.|||.|||..........|||.|||.|
|.....|||.||||||||.|||.....|
|.|||.|||.||||||||.|||.|||.|
|.|||.....||||||||.....|||.|
|.||||.||.||||||||.||.||||.|
|.||||.||.||||||||.||.||||.|
|......||..........||......|
|.||||.||.||.||.||.||.||||.|
|.||||.||.||.||.||.||.||||.|
|.||||.||.||.||.||.||.||||.|
|.||||.||.||.||.||.||.||||.|
|.........||.||.||.........|
|.||.||||.||.||.||.||||.||.|
|.||.||||.||.||.||.||||.||.|
|.||.|||............|||.||.|
|.||.|||.||||..||||.|||.||.|
|.||.|||.||||..||||.|||.||.|
|.||.|||.||||..||||.|||.||.|
|..........................|
||||||||||||||||||||||||||||
