
||||||||||||||||||||||||||||
|..........................|
|.||||.||||||..||||||.||||.|
|.||||.||||||..||||||.||||.|
|.||||................||||.|
|......||||.||||.||||......|
|.||||.||||.||||.||||.||||.|
|.||||.||||.||||.||||.||||.|
|.||||.||||..||..||||.||||.|
|.........||.||.||.........|
|.||.||||.||.||.||.||||.||.|
|.||.||||..........||||.||.|
|.||.||||.||||||||.||||.||.|
|.||.||||.||||||||.||||.||.|
|.........||||||||.........|
|.|||||||.||||||||.|||||||.|
|.|||||||.||||||||.|||||||.|
|.|||||||..........|||||||.|
|.|||||||..||||||..|||||||.|
|..........||||||..........|
|.||||.|||.||||||.|||.||||.|
|.||||.|||........|||.||||.|
|......|||.||..||.|||......|
|.||||||||.||..||.||||||||.|
|.||||||||.||..||.||||||||.|
|..........||..||..........|
|.|||||.||.||..||.||.|||||.|
|.|||||.||.||..||.||.|||||.|
|.|||||.||.||..||.||.|||||.|
|..........................|
||||||||||||||||||||||||||||
