
||||||||||||||||||||||||||||
|..........................|
|.||.||.||.||||||.||.||.||.|
|.||.||.||.||||||.||.||.||.|
|.||.||....||||||....||.||.|
|.||.|||||.||||||.|||||.||.|
|....|||||.||||||.|||||....|
|.||.|||||.||||||.|||||.||.|
|.||........||||........||.|
|.||.||||||.||||.||||||.||.|
|.||.||||||.||||.||||||.||.|
|.||.||||..........||||.||.|
|.||.||||.||||||||.||||.||.|
|.........||||||||.........|
|.|||||||.||||||||.|||||||.|
|.|||||||.||||||||.|||||||.|
|.|||||||.||||||||.|||||||.|
|.|||..................|||.|
|.|||.|||||.||||.|||||.|||.|
|.....|||||.||||.|||||.....|
|.|||.|||||.||||.|||||.|||.|
|.|||........||........|||.|
|.|||.|||.||....||.|||.|||.|
|.|||.|||.||||||||.|||.|||.|
|.|||.|||.||||||||.|||.|||.|
|.|||.|||.||||||||.|||.|||.|
|..........................|
|.||.||||||||||||||||||.||.|
|.||.||||||||||||||||||.||.|
|..........................|
||||||||||||||||||||||||||||
