
||||||||||||||||||||||||||||
|..........................|
|.|||||||||.||||.|||||||||.|
|.|||||||||.||||.|||||||||.|
|......||||.||||.||||......|
|.||||.||||.||||.||||.||||.|
|.||||................||||.|
|....|||.||||..||||.|||....|
|.||.|||.||||..||||.|||.||.|
|.||.|||.||||..||||.|||.||.|
|.....||.||||..||||.||.....|
|.|||.||............||.|||.|
|.|||.....||||||||.....|||.|
|.||||.||.||||||||.||.||||.|
|.||||.||.||||||||.||.||||.|
|.||||.||.||||||||.||.||||.|
|.||||.||.||||||||.||.||||.|
|..........................|
|.||||||.||||..||||.||||||.|
|.||||||.||||..||||.||||||.|
|.||||||.||||..||||.||||||.|
|.||||||.||||..||||.||||||.|
|..........||..||..........|
|.||.||.||.||..||.||.||.||.|
|.||.||.||.||..||.||.||.||.|
|.||.||.||........||.||.||.|
|.||.||.|||.||||.|||.||.||.|
|.||.||.|||.||||.|||.||.||.|
|.||.||.|||.||||.|||.||.||.|
|..........................|
||||||||||||||||||||||||||||
