
||||||||||||||||||||||||||||
|..........................|
|.||.|||||||.||.|||||||.||.|
|.||.|||||||.||.|||||||.||.|
|.||.........||.........||.|
|.|||.||||||||||||||||.|||.|
|.|||.||||||||||||||||.|||.|
|.||....................||.|
|.||.|||.||||..||||.|||.||.|
|.||.|||.||||..||||.|||.||.|
|.||.|||.||||..||||.|||.||.|
|.||.|||............|||.||.|
|.||.|||..||||||||..|||.||.|
|.........||||||||.........|
|.|||||||.||||||||.|||||||.|
|.|||||||.||||||||.|||||||.|
|.||......||||||||......||.|
|....||||..........||||....|
|.|||||||..||||||..|||||||.|
|.|||||....||||||....|||||.|
|.......||.||||||.||.......|
|.||||.|||.||||||.|||.||||.|
|.||||.||..........||.||||.|
|.||||.||.||||||||.||.||||.|
|.||||.||.||||||||.||.||||.|
|.||||.||.||||||||.||.||||.|
|.||||.||.||||||||.||.||||.|
|.||||.||.||||||||.||.||||.|
|.||||.||.||||||||.||.||||.|
|..........................|
||||||||||||||||||||||||||||
