
||||||||||||||||||||||||||||
|..........................|
|.|||.||.||||||||||.||.|||.|
|.|||.||.||||||||||.||.|||.|
|.|||.||............||.|||.|
|.|||.||||||||||||||||.|||.|
|.....||||||||||||||||.....|
|.|||..................|||.|
|.|||||||.||||||||.|||||||.|
|.|||||||.||||||||.|||||||.|
|.........||||||||.........|
|.||.||||..........||||.||.|
|.||.||||.||||||||.||||.||.|
|.||.||||.||||||||.||||.||.|
|....||||.||||||||.||||....|
|.||......||||||||......||.|
|.||.||||.||||||||.||||.||.|
|.||.||||..........||||.||.|
|.||.||||.||.||.||.||||.||.|
|.||.||...||.||.||...||.||.|
|.||....||||.||.||||....||.|
|....||.||||.||.||||.||....|
|.||.||.||||.||.||||.||.||.|
|.||.||......||......||.||.|
|.||.||.||||.||.||||.||.||.|
|.||.||.||||....||||.||.||.|
|.||.||...||.||.||...||.||.|
|.||.||||.||.||.||.||||.||.|
|.||.||||.||.||.||.||||.||.|
|..........................|
||||||||||||||||||||||||||||
