
||||||||||||||||||||||||||||
|..........................|
|.||||||.||||||||||.||||||.|
|.||||||.||||||||||.||||||.|
|.|||..................|||.|
|.|||.||.|||.||.|||.||.|||.|
|.....||.|||.||.|||.||.....|
|.|||.||.|||.||.|||.||.|||.|
|.|||.||.|||....|||.||.|||.|
|.|||.||.||||..||||.||.|||.|
|.|||.||.||||..||||.||.|||.|
|..........................|
|.||||.||.||||||||.||.||||.|
|.||||.||.||||||||.||.||||.|
|.||||.||.||||||||.||.||||.|
|.||||.||.||||||||.||.||||.|
|.........||||||||.........|
|.|||||..............|||||.|
|.|||||.|||.||||.|||.|||||.|
|.||....|||.||||.|||....||.|
|.||.||.|||..||..|||.||.||.|
|....||.|||.||||.|||.||....|
|.|||||.....||||.....|||||.|
|.|||||.|||......|||.|||||.|
|.......||||||||||||.......|
|.|||||.||||||||||||.|||||.|
|.|||||..||......||..|||||.|
|.||||||.||.||||.||.||||||.|
|.||||||.||.||||.||.||||||.|
|..........................|
||||||||||||||||||||||||||||
