
||||||||||||||||||||||||||||
|..........................|
|.||||.||||.||||.||||.||||.|
|.||||.||||.||||.||||.||||.|
|.......|||.||||.|||.......|
|.|||||..............|||||.|
|.|||||.||||||||||||.|||||.|
|.|||||.||||||||||||.|||||.|
|..........................|
|.||.|||.||||||||||.|||.||.|
|.||.|||.||||||||||.|||.||.|
|....|||............|||....|
|.||..|||.||||||||.|||..||.|
|.|||.|||.||||||||.|||.|||.|
|.|||.....||||||||.....|||.|
|.|||.|||.||||||||.|||.|||.|
|.|||.|||.||||||||.|||.|||.|
|.|||.|||..........|||.|||.|
|.....|||.||.||.||.|||.....|
|.|||.....||.||.||.....|||.|
|.||||||.|||.||.|||.||||||.|
|.||||||.|||.||.|||.||||||.|
|.|||....|||.||.|||....|||.|
|.|||.||.|||.||.|||.||.|||.|
|.....||.|||.||.|||.||.....|
|.|||.||.|||....|||.||.|||.|
|.|||.||.....||.....||.|||.|
|.|||.||||||.||.||||||.|||.|
|.|||.||||||.||.||||||.|||.|
|..........................|
||||||||||||||||||||||||||||
