
||||||||||||||||||||||||||||
|..........................|
|.||||.||.||||||||.||.||||.|
|.||||.||.||||||||.||.||||.|
|.||||.||...||||...||.||||.|
|.||||.||||.||||.||||.||||.|
|.||||.||||......||||.||||.|
|...........||||...........|
|.||.|||||.||||||.|||||.||.|
|.||.|||||.||||||.|||||.||.|
|.......||.||||||.||.......|
|.|||||..............|||||.|
|.|||||||.||||||||.|||||||.|
|.|||||||.||||||||.|||||||.|
|.||||....||||||||....||||.|
|.||...||.||||||||.||...||.|
|.||.||||.||||||||.||||.||.|
|.||.|||............|||.||.|
|.....||.||||||||||.||.....|
|.|||.||.||||||||||.||.|||.|
|.|||.||.||||||||||.||.|||.|
|.|||..................|||.|
|.||||.||||||..||||||.||||.|
|.||||.||||||..||||||.||||.|
|......||..........||......|
|.||||.||.||||||||.||.||||.|
|.||||.||.||||||||.||.||||.|
|.||||.||.||||||||.||.||||.|
|.||||.||.||||||||.||.||||.|
|..........................|
||||||||||||||||||||||||||||
