
||||||||||||||||||||||||||||
|..........................|
|.||||||.||.||||.||.||||||.|
|.||||||.||.||||.||.||||||.|
|.||||||....||||....||||||.|
|.||||||.||.||||.||.||||||.|
|........||.||||.||........|
|.||.|||.||......||.|||.||.|
|.||.|||.|||.||.|||.|||.||.|
|.||......||.||.||......||.|
|.|||||||.||.||.||.|||||||.|
|.|||||||..........|||||||.|
|.||......||||||||......||.|
|.||.||||.||||||||.||||.||.|
|....||||.||||||||.||||....|
|.||.||||.||||||||.||||.||.|
|.||.||||.||||||||.||||.||.|
|.||.||||..........||||.||.|
|.||.||...||.||.||...||.||.|
|.||.||.||||.||.||||.||.||.|
|.......||||.||.||||.......|
|.|||.||||||.||.||||||.|||.|
|.|||.|||||......|||||.|||.|
|.|||.||....||||....||.|||.|
|.|||....||.||||.||....|||.|
|.....|||||..||..|||||.....|
|.|||.||||||.||.||||||.|||.|
|.|||.||||||.||.||||||.|||.|
|.|||.||||||.||.||||||.|||.|
|..........................|
||||||||||||||||||||||||||||
