
||||||||||||||||||||||||||||
|..........................|
|.||||||.||||..||||.||||||.|
|.||||||.||||..||||.||||||.|
|........||||..||||........|
|.|||.||.||||..||||.||.|||.|
|.|||.||............||.|||.|
|.....||.||||||||||.||.....|
|.|||.||.||||||||||.||.|||.|
|.|||.||..||||||||..||.|||.|
|.|||.|||.||||||||.|||.|||.|
|.|||.|||..........|||.|||.|
|.|||.|||.||||||||.|||.|||.|
|.|||.....||||||||.....|||.|
|.....|||.||||||||.|||.....|
|.|||||||.||||||||.|||||||.|
|.|||||||.||||||||.|||||||.|
|.||||||............||||||.|
|........||||||||||........|
|.||.|||.||||||||||.|||.||.|
|.||.|||.||||||||||.|||.||.|
|.||.....||||||||||.....||.|
|.|||||..............|||||.|
|.|||||.|||.||||.|||.|||||.|
|.......|||.||||.|||.......|
|.|||||.|||.||||.|||.|||||.|
|.|||||.|||.||||.|||.|||||.|
|.|||||.|||.||||.|||.|||||.|
|.|||||.|||.||||.|||.|||||.|
|..........................|
||||||||||||||||||||||||||||
