
||||||||||||||||||||||||||||
|..........................|
|.||||.||||||||||||||.||||.|
|.||||.||||||||||||||.||||.|
|.||||................||||.|
|.||||.||||||||||||||.||||.|
|.||||.||||||||||||||.||||.|
|..........||..||..........|
|.||||||||.||..||.||||||||.|
|.||||||||.||..||.||||||||.|
|.||||||||.||..||.||||||||.|
|..........................|
|.|||||||.||||||||.|||||||.|
|.|||||||.||||||||.|||||||.|
|.........||||||||.........|
|.|||||||.||||||||.|||||||.|
|.|||||||.||||||||.|||||||.|
|.||....................||.|
|....||..||||||||||..||....|
|.||||||.||||||||||.||||||.|
|.||||||............||||||.|
|....|||.||||||||||.|||....|
|.||.|||.||||||||||.|||.||.|
|.||.....||......||.....||.|
|.||.|||.||.||||.||.|||.||.|
|.||.|||.||.||||.||.|||.||.|
|.||.|||.||.||||.||.|||.||.|
|.||.|||.||.||||.||.|||.||.|
|.||.|||.||.||||.||.|||.||.|
|..........................|
||||||||||||||||||||||||||||
