
||||||||||||||||||||||||||||
|..........................|
|.||.||.||.||..||.||.||.||.|
|.||.||.||.||..||.||.||.||.|
|....||....||..||....||....|
|.||||||||.||..||.||||||||.|
|.||||||||.||..||.||||||||.|
|....||....||..||....||....|
|.||.||.||.||..||.||.||.||.|
|.||....||.||..||.||....||.|
|.||||||||.||..||.||||||||.|
|.|||||||..........|||||||.|
|.........||||||||.........|
|.|||||||.||||||||.|||||||.|
|.|||||||.||||||||.|||||||.|
|......||.||||||||.||......|
|.||||.||.||||||||.||.||||.|
|.||||.||..........||.||||.|
|.||||.||.|||..|||.||.||||.|
|.||......|||..|||......||.|
|.||.||||..||..||..||||.||.|
|.||.|||||.||..||.|||||.||.|
|.||.||.||.||..||.||.||.||.|
|....||....||..||....||....|
|.||||||||.||..||.||||||||.|
|.||||||||.||..||.||||||||.|
|..........................|
|.||||.||||||..||||||.||||.|
|.||||.||||||..||||||.||||.|
|..........................|
||||||||||||||||||||||||||||
