
||||||||||||||||||||||||||||
|..........................|
|.||||||.|||.||.|||.||||||.|
|.||||||.|||.||.|||.||||||.|
|.||||||.|||.||.|||.||||||.|
|.||||||.|||.||.|||.||||||.|
|............||............|
|.||||.||.||.||.||.||.||||.|
|.||||.||.||....||.||.||||.|
|.||||.||.||.||.||.||.||||.|
|.||||.||.||.||.||.||.||||.|
|......||..........||......|
|.||||.||.||||||||.||.||||.|
|.||||....||||||||....||||.|
|.|||..||.||||||||.||..|||.|
|.|||.|||.||||||||.|||.|||.|
|.....|||.||||||||.|||.....|
|.||||||............||||||.|
|.||||||.||.||||.||.||||||.|
|.||||||.||.||||.||.||||||.|
|.||||||.||.||||.||.||||||.|
|.|||....||.||||.||....|||.|
|.|||.|||||......|||||.|||.|
|.....|||||.||||.|||||.....|
|.|||....||.||||.||....|||.|
|.|||.||............||.|||.|
|.||..||||.||||||.||||..||.|
|.||.|||||.||||||.|||||.||.|
|.||.|||||.||||||.|||||.||.|
|..........................|
||||||||||||||||||||||||||||
