
||||||||||||||||||||||||||||
|..........................|
|.||.||||||||||||||||||.||.|
|.||.||||||||||||||||||.||.|
|..........................|
|.|||||||.|||..|||.|||||||.|
|.|||||||.|||..|||.|||||||.|
|.........|||..|||.........|
|.||.||||.|||..|||.||||.||.|
|.||.||||.|||..|||.||||.||.|
|.||.||||.|||..|||.||||.||.|
|.||.||||..........||||.||.|
|.||......||||||||......||.|
|.||.||||.||||||||.||||.||.|
|.||.||||.||||||||.||||.||.|
|.||.||||.||||||||.||||.||.|
|.||......||||||||......||.|
|....||||..........||||....|
|.||.||||.||.||.||.||||.||.|
|.||.||||.||.||.||.||||.||.|
|.||.||||.||.||.||.||||.||.|
|.||......||....||......||.|
|.||.||||.|||..|||.||||.||.|
|.||.||||.|||..|||.||||.||.|
|..........................|
|.|||||.||.||||||.||.|||||.|
|.|||||.||.||||||.||.|||||.|
|.|||||.||.||||||.||.|||||.|
|.|||||.||.||||||.||.|||||.|
|..........................|
||||||||||||||||||||||||||||
