
||||||||||||||||||||||||||||
|..........................|
|.|||||||.||||||||.|||||||.|
|.|||||||.||||||||.|||||||.|
|....||||.||||||||.||||....|
|.||.||||.||||||||.||||.||.|
|.||.||..............||.||.|
|.||.||.|||||..|||||.||.||.|
|.||....|||||..|||||....||.|
|.||.||...|||..|||...||.||.|
|.||.||||.|||..|||.||||.||.|
|....||||..........||||....|
|.||.||||.||||||||.||||.||.|
|.||......||||||||......||.|
|.|||.|||.||||||||.|||.|||.|
|.|||.|||.||||||||.|||.|||.|
|.|||.|||.||||||||.|||.|||.|
|.....|||..........|||.....|
|.|||.....||||||||.....|||.|
|.|||.|||.||||||||.|||.|||.|
|.|||.|||..........|||.|||.|
|.|||.|||.||||||||.|||.|||.|
|.|||.|||.||||||||.|||.|||.|
|............||............|
|.||||||.|||.||.|||.||||||.|
|.||||||.|||.||.|||.||||||.|
|.||||||.|||.||.|||.||||||.|
|.||||||.|||.||.|||.||||||.|
|.||||||.|||.||.|||.||||||.|
|..........................|
||||||||||||||||||||||||||||
