
||||||||||||||||||||||||||||
|..........................|
|.|||.||||.||||||.||||.|||.|
|.|||.||||.||||||.||||.|||.|
|......|||.||||||.|||......|
|.||||................||||.|
|.||||.||||||||||||||.||||.|
|.||||.||||||||||||||.||||.|
|.||||.......||.......||||.|
|......|||||.||.|||||......|
|.||||.|||||.||.|||||.||||.|
|.||||.||..........||.||||.|
|.........||||||||.........|
|.|||||||.||||||||.|||||||.|
|.|||||||.||||||||.|||||||.|
|.||......||||||||......||.|
|.||.|||..||||||||..|||.||.|
|.||.|||............|||.||.|
|.||.|||.||.||||.||.|||.||.|
|....|||.||.||||.||.|||....|
|.||.....||......||.....||.|
|.|||.|||||||..|||||||.|||.|
|.|||.|||||||..|||||||.|||.|
|.||......|||..|||......||.|
|....||||.|||..|||.||||....|
|.|||||||..........|||||||.|
|.|||||||.||||||||.|||||||.|
|.|||||||.||||||||.|||||||.|
|.|||||||.||||||||.|||||||.|
|..........................|
||||||||||||||||||||||||||||
