
||||||||||||||||||||||||||||
|..........................|
|.|||||||.||||||||.|||||||.|
|.|||||||.||||||||.|||||||.|
|..........||||||..........|
|.||||.|||.||||||.|||.||||.|
|.||||.|||.||||||.|||.||||.|
|.||||.|||........|||.||||.|
|.||||.|||.||||||.|||.||||.|
|.......||.||||||.||.......|
|.||.||.||.||||||.||.||.||.|
|.||.||..............||.||.|
|.||.||||.||||||||.||||.||.|
|.||.||||.||||||||.||||.||.|
|.||.||||.||||||||.||||.||.|
|.||.||||.||||||||.||||.||.|
|.||.||||.||||||||.||||.||.|
|..........................|
|.||||||||.||..||.||||||||.|
|.||||||||.||..||.||||||||.|
|.....||||.||..||.||||.....|
|.|||.||||.||||||.||||.|||.|
|.|||......||||||......|||.|
|.||||.|||........|||.||||.|
|.||||.||||||..||||||.||||.|
|.||||.||||||..||||||.||||.|
|..........||..||..........|
|.||||||||.||..||.||||||||.|
|.||||||||.||..||.||||||||.|
|..........................|
||||||||||||||||||||||||||||
