
||||||||||||||||||||||||||||
|..........................|
|.||.||||.||||||||.||||.||.|
|.||.||||.||||||||.||||.||.|
|.||.||||.||||||||.||||.||.|
|.||.||||.||||||||.||||.||.|
|.||....................||.|
|.||.||.||||.||.||||.||.||.|
|....||.||||.||.||||.||....|
|.||.||.||||.||.||||.||.||.|
|.||......||.||.||......||.|
|.||.||||..........||||.||.|
|.||.||||.||||||||.||||.||.|
|.||.||||.||||||||.||||.||.|
|.||.||||.||||||||.||||.||.|
|.........||||||||.........|
|.||.||||.||||||||.||||.||.|
|.||.||||..........||||.||.|
|....||||.||.||.||.||||....|
|.||......||.||.||......||.|
|.||.|||.||..||..||.|||.||.|
|.||.|||.||..||..||.|||.||.|
|.||.....|||....|||.....||.|
|.||||||.||||||||||.||||||.|
|.||||||.||||||||||.||||||.|
|..........||||||..........|
|.|||.||||........||||.|||.|
|.|||.||||||||||||||||.|||.|
|.|||.||||||||||||||||.|||.|
|..........................|
||||||||||||||||||||||||||||
