
||||||||||||||||||||||||||||
|..........................|
|.||||||.||||||||||.||||||.|
|.||||||.||||||||||.||||||.|
|..........||||||..........|
|.||||.|||.||||||.|||.||||.|
|.||||.|||.||||||.|||.||||.|
|.||||.|||........|||.||||.|
|......|||.||||||.|||......|
|.||||.|||.||||||.|||.||||.|
|.||||.|||.||||||.|||.||||.|
|..........................|
|.|||||||.||||||||.|||||||.|
|.|||||||.||||||||.|||||||.|
|.|||.....||||||||.....|||.|
|.|||.|||.||||||||.|||.|||.|
|.....|||.||||||||.|||.....|
|.|||||||..........|||||||.|
|.|||||||.||||||||.|||||||.|
|.........||||||||.........|
|.||.||.||||....||||.||.||.|
|.||.||.||||.||.||||.||.||.|
|.||.||.||||.||.||||.||.||.|
|.||.||......||......||.||.|
|.||.||.||||.||.||||.||.||.|
|.||.||.||||.||.||||.||.||.|
|.||.||...||.||.||...||.||.|
|.||.||||.||.||.||.||||.||.|
|.||.||||.||.||.||.||||.||.|
|..........................|
||||||||||||||||||||||||||||
