
||||||||||||||||||||||||||||
|..........................|
|.|||||.||||.||.||||.|||||.|
|.|||||.||||.||.||||.|||||.|
|.|||||.||||.||.||||.|||||.|
|.......||||.||.||||.......|
|.|||||......||......|||||.|
|.|||||.||||.||.||||.|||||.|
|.|||||.||||....||||.|||||.|
|.|||||.||||.||.||||.|||||.|
|.......||||.||.||||.......|
|.||||................||||.|
|.||||.||.||||||||.||.||||.|
|.||||.||.||||||||.||.||||.|
|.||||....||||||||....||||.|
|......||.||||||||.||......|
|.|||||||.||||||||.|||||||.|
|.||||||............||||||.|
|.||||||.||||..||||.||||||.|
|.||||||.||||..||||.||||||.|
|.||||||.||||..||||.||||||.|
|..........................|
|.||.||||||.||||.||||||.||.|
|.||.||||||.||||.||||||.||.|
|..........................|
|.||||.||.||||||||.||.||||.|
|.||||.||.||||||||.||.||||.|
|.||||.||.||||||||.||.||||.|
|.||||.||.||||||||.||.||||.|
|..........................|
||||||||||||||||||||||||||||
