
||||||||||||||||||||||||||||
|..........................|
|.||.||||.||||||||.||||.||.|
|.||.||||.||||||||.||||.||.|
|.||.||||.||||||||.||||.||.|
|....||..............||....|
|.||||..||.||||||.||..||||.|
|.||||.|||.||||||.|||.||||.|
|......|||.||||||.|||......|
|.||||.|||.||||||.|||.||||.|
|.||||.....||||||.....||||.|
|.||||.||..........||.||||.|
|.||||.||.||||||||.||.||||.|
|......||.||||||||.||......|
|.||||.||.||||||||.||.||||.|
|.||||.||.||||||||.||.||||.|
|......||.||||||||.||......|
|.||||.||..........||.||||.|
|.||||.||.||||||||.||.||||.|
|.||||.||.||||||||.||.||||.|
|.||||.||.||||||||.||.||||.|
|.||||......||||......||||.|
|.||||||.||.||||.||.||||||.|
|.....||.||......||.||.....|
|.||.....||||..||||.....||.|
|.||.|||.||||..||||.|||.||.|
|.||.|||...||..||...|||.||.|
|.||.|||||.||..||.|||||.||.|
|.||.|||||.||..||.|||||.||.|
|..........................|
||||||||||||||||||||||||||||
