
||||||||||||||||||||||||||||
|..........................|
|.||||.|||.||||||.|||.||||.|
|.||||.|||.||||||.|||.||||.|
|.||||.|||.||||||.|||.||||.|
|.......||.||||||.||.......|
|.|||||..............|||||.|
|.|||||.|||||..|||||.|||||.|
|.|||||.|||||..|||||.|||||.|
|.........|||..|||.........|
|.||||.||.|||..|||.||.||||.|
|.||||.||..........||.||||.|
|.||||.||.||||||||.||.||||.|
|.||||.||.||||||||.||.||||.|
|.||||.||.||||||||.||.||||.|
|.||||.||.||||||||.||.||||.|
|......||.||||||||.||......|
|.||||................||||.|
|.||||.||||.||||.||||.||||.|
|.||||.||||.||||.||||.||||.|
|.||||.||||.||||.||||.||||.|
|.||||.||||.||||.||||.||||.|
|.||||.||||......||||.||||.|
|......||||.||||.||||......|
|.||||......||||......||||.|
|.||||.|||.||..||.|||.||||.|
|.|||..|||.||||||.|||..|||.|
|.|||.||||.||||||.||||.|||.|
|.|||.||||.||||||.||||.|||.|
|..........................|
||||||||||||||||||||||||||||
