
||||||||||||||||||||||||||||
|..........................|
|.|||||.||.||..||.||.|||||.|
|.|||||.||.||..||.||.|||||.|
|.|||||....||..||....|||||.|
|.|||||.||.||||||.||.|||||.|
|.......||.||||||.||.......|
|.|||||.||.||..||.||.|||||.|
|.|||||.||.||..||.||.|||||.|
|.|||||.||.||..||.||.|||||.|
|.|||||.||.||..||.||.|||||.|
|..........................|
|.|||||||.||||||||.|||||||.|
|.|||||||.||||||||.|||||||.|
|.....|||.||||||||.|||.....|
|.|||.|||.||||||||.|||.|||.|
|.|||.....||||||||.....|||.|
|.|||.|||..........|||.|||.|
|.|||.||||||||||||||||.|||.|
|.......||||||||||||.......|
|.|||||.||||||||||||.|||||.|
|.|||||...||||||||...|||||.|
|.|||||||..........|||||||.|
|.|||||||.||.||.||.|||||||.|
|.........||.||.||.........|
|.|||||.||||.||.||||.|||||.|
|.|||||.||||.||.||||.|||||.|
|.|||||.||||.||.||||.|||||.|
|.|||||.||||.||.||||.|||||.|
|..........................|
||||||||||||||||||||||||||||
