
||||||||||||||||||||||||||||
|..........................|
|.||.||.||.||||||.||.||.||.|
|.||.||.||.||||||.||.||.||.|
|.||.||.||.||||||.||.||.||.|
|.||.||.||.||||||.||.||.||.|
|.||.||.||.||..||.||.||.||.|
|.||....||........||....||.|
|.|||||.|||.||||.|||.|||||.|
|.|||||.|||.||||.|||.|||||.|
|.......|||.||||.|||.......|
|.|||||..............|||||.|
|.|||||||.||||||||.|||||||.|
|.||||.||.||||||||.||.||||.|
|.||||....||||||||....||||.|
|......||.||||||||.||......|
|.||.||||.||||||||.||||.||.|
|.||.|||............|||.||.|
|.||.|||.|||.||.|||.|||.||.|
|.||.|||.|||.||.|||.|||.||.|
|.||.|||.|||.||.|||.|||.||.|
|.||.|||.|||.||.|||.|||.||.|
|.||....................||.|
|.||.||||||.||||.||||||.||.|
|.||.||||||.||||.||||||.||.|
|.||........||||........||.|
|....||||||.||||.||||||....|
|.||.||||||.||||.||||||.||.|
|.||.||||||.||||.||||||.||.|
|..........................|
||||||||||||||||||||||||||||
