
||||||||||||||||||||||||||||
|..........................|
|.|||||||.||||||||.|||||||.|
|.|||||||.||||||||.|||||||.|
|......||.||||||||.||......|
|.||||................||||.|
|.||||.||||||..||||||.||||.|
|.||||.||||||..||||||.||||.|
|..........................|
|.|||||||.||||||||.|||||||.|
|.|||||||.||||||||.|||||||.|
|.|||||||..........|||||||.|
|.........||||||||.........|
|.|||||||.||||||||.|||||||.|
|.|||||||.||||||||.|||||||.|
|.........||||||||.........|
|.||||.||.||||||||.||.||||.|
|.||||.||..........||.||||.|
|.|||...||.||||||.||...|||.|
|.|||.||||.||||||.||||.|||.|
|.|||.||||.||||||.||||.|||.|
|.|||.||||.||||||.||||.|||.|
|.....||||........||||.....|
|.|||.||||.||||||.||||.|||.|
|.|||......||||||......|||.|
|.|||.||||.||||||.||||.|||.|
|.|||.||||.||..||.||||.|||.|
|.|||.||||.||..||.||||.|||.|
|.|||.||||.||..||.||||.|||.|
|..........................|
||||||||||||||||||||||||||||
