
||||||||||||||||||||||||||||
|..........................|
|.||||||.||||..||||.||||||.|
|.||||||.||||..||||.||||||.|
|.||||||.||||..||||.||||||.|
|.||||||.||||||||||.||||||.|
|........||||||||||........|
|.|||.||.||||..||||.||.|||.|
|.|||.||............||.|||.|
|.|||.||.||||||||||.||.|||.|
|.|||.||.||||||||||.||.|||.|
|..........................|
|.||.||||.||||||||.||||.||.|
|.||.||||.||||||||.||||.||.|
|.||.||||.||||||||.||||.||.|
|.||.||||.||||||||.||||.||.|
|.||.||||.||||||||.||||.||.|
|.||.||..............||.||.|
|....||.|||.||||.|||.||....|
|.||....|||.||||.|||....||.|
|.|||.|||||.||||.|||||.|||.|
|.|||.|||||.||||.|||||.|||.|
|.|||..................|||.|
|.....||||.||..||.||||.....|
|.|||.||||.||..||.||||.|||.|
|.|||.||||.||||||.||||.|||.|
|.|||......||||||......|||.|
|.|||.||||.||||||.||||.|||.|
|.|||.||||.||||||.||||.|||.|
|..........................|
||||||||||||||||||||||||||||
