
||||||||||||||||||||||||||||
|..........................|
|.||||.|||.||||||.|||.||||.|
|.||||.|||.||||||.|||.||||.|
|.||||.|||.||||||.|||.||||.|
|.||||.|||........|||.||||.|
|.||||.|||.||||||.|||.||||.|
|.|||......||||||......|||.|
|.....||||..||||..||||.....|
|.|||.|||||.||||.|||||.|||.|
|.|||.|||||.||||.|||||.|||.|
|.|||..................|||.|
|.|||.|||.||||||||.|||.|||.|
|.|||.|||.||||||||.|||.|||.|
|.........||||||||.........|
|.|||||||.||||||||.|||||||.|
|.|||||||.||||||||.|||||||.|
|.||....................||.|
|.||.|||.|||.||.|||.|||.||.|
|.||.|||.|||.||.|||.|||.||.|
|.||.|||.|||.||.|||.|||.||.|
|.||.....|||.||.|||.....||.|
|....|||.|||.||.|||.|||....|
|.||||||.|||.||.|||.||||||.|
|.||||||.....||.....||||||.|
|....|||.|||....|||.|||....|
|.||.||..||||..||||..||.||.|
|.||.||.|||||..|||||.||.||.|
|.||.||.|||||..|||||.||.||.|
|..........................|
||||||||||||||||||||||||||||
