
||||||||||||||||||||||||||||
|..........................|
|.|||.||||.||||||.||||.|||.|
|.|||.||||.||||||.||||.|||.|
|.|||.||||........||||.|||.|
|.|||.||||.||||||.||||.|||.|
|.||.......||||||.......||.|
|.||.|||||.||||||.|||||.||.|
|.||.|||||.||||||.|||||.||.|
|.......||.||||||.||.......|
|.|||||.||.||||||.||.|||||.|
|.|||||..............|||||.|
|.|||||||.||||||||.|||||||.|
|.|||||||.||||||||.|||||||.|
|.||||....||||||||....||||.|
|......||.||||||||.||......|
|.|||||||.||||||||.|||||||.|
|.|||||..............|||||.|
|.|||||.||.||||||.||.|||||.|
|.|||||.||.||||||.||.|||||.|
|....||.||.||||||.||.||....|
|.||....||........||....||.|
|.||||.|||.||..||.|||.||||.|
|.||||.|||.||..||.|||.||||.|
|.||.......||..||.......||.|
|.||.|||.||||..||||.|||.||.|
|.||.|||.||||..||||.|||.||.|
|.||.|||.||||..||||.|||.||.|
|.||.|||.||||..||||.|||.||.|
|..........................|
||||||||||||||||||||||||||||
