
||||||||||||||||||||||||||||
|..........................|
|.||||||.||||..||||.||||||.|
|.||||||.||||..||||.||||||.|
|....|||.||||..||||.|||....|
|.||.|||.||||..||||.|||.||.|
|.||....................||.|
|.||||.||||.||||.||||.||||.|
|.||||.||||.||||.||||.||||.|
|.||||..|||.||||.|||..||||.|
|.......|||.||||.|||.......|
|.|||||..............|||||.|
|.|||||||.||||||||.|||||||.|
|.||...||.||||||||.||...||.|
|.........||||||||.........|
|.|||||||.||||||||.|||||||.|
|.|||||||.||||||||.|||||||.|
|..........................|
|.||||.||||.||||.||||.||||.|
|.||||.||||.||||.||||.||||.|
|.||.....||.||||.||.....||.|
|....|||.||.||||.||.|||....|
|.||||||.||.||||.||.||||||.|
|.|||||.....||||.....|||||.|
|.......||||||||||||.......|
|.|||||.||||||||||||.|||||.|
|.|||||..............|||||.|
|.|||||.||||||||||||.|||||.|
|.|||||.||||||||||||.|||||.|
|..........................|
||||||||||||||||||||||||||||
