
||||||||||||||||||||||||||||
|..........................|
|.||||.||||||..||||||.||||.|
|.||||.||||||..||||||.||||.|
|..........................|
|.||||||.||||||||||.||||||.|
|.||||||.||||||||||.||||||.|
|.||||||.||||||||||.||||||.|
|.||||||............||||||.|
|........||||||||||........|
|.||||||.||||||||||.||||||.|
|.||||||............||||||.|
|.|||||||.||||||||.|||||||.|
|.|||||||.||||||||.|||||||.|
|.........||||||||.........|
|.|||..||.||||||||.||..|||.|
|.|||||||.||||||||.|||||||.|
|.|||||..............|||||.|
|.......||.||||||.||.......|
|.||.||.||.||||||.||.||.||.|
|.||.||.||........||.||.||.|
|.||.||.||..||||..||.||.||.|
|.||.||.|||.||||.|||.||.||.|
|.||.||.|||.||||.|||.||.||.|
|.||.||......||......||.||.|
|.||.||.||||.||.||||.||.||.|
|....||.||||.||.||||.||....|
|.||.||.||||.||.||||.||.||.|
|.||.||.||||.||.||||.||.||.|
|..........................|
||||||||||||||||||||||||||||
