
||||||||||||||||||||||||||||
|..........................|
|.||.||.|||.||||.|||.||.||.|
|.||.||.|||.||||.|||.||.||.|
|.||....|||.||||.|||....||.|
|.||.||.|||.||||.|||.||.||.|
|.||.||.|||......|||.||.||.|
|.||.||.|||.||||.|||.||.||.|
|....||.|||.||||.|||.||....|
|.||.||.|||.||||.|||.||.||.|
|.||.||.|||.||||.|||.||.||.|
|..........................|
|.|||.|||.||||||||.|||.|||.|
|.|||.|||.||||||||.|||.|||.|
|.|||.|||.||||||||.|||.|||.|
|.|||.|||.||||||||.|||.|||.|
|.|||.|||.||||||||.|||.|||.|
|..........................|
|.||||.|||.||||||.|||.||||.|
|.||||.|||.||||||.|||.||||.|
|.||||.|||.||||||.|||.||||.|
|.||||.|||........|||.||||.|
|............||............|
|.||||.|||||.||.|||||.||||.|
|.||||.|||||.||.|||||.||||.|
|.||||.|||||.||.|||||.||||.|
|.||||.......||.......||||.|
|.||||.|||||.||.|||||.||||.|
|.||||.|||||.||.|||||.||||.|
|..........................|
||||||||||||||||||||||||||||
