
||||||||||||||||||||||||||||
|..........................|
|.||.||.||.||||||.||.||.||.|
|.||.||.||.||||||.||.||.||.|
|.||.||.||........||.||.||.|
|.||.||.||.||||||.||.||.||.|
|....||.||.||||||.||.||....|
|.|||||.||.||||||.||.|||||.|
|.|||||..............|||||.|
|.......||||||||||||.......|
|.||||.||||||||||||||.||||.|
|.||||.||..........||.||||.|
|.||||....||||||||....||||.|
|.||||.||.||||||||.||.||||.|
|.||||.||.||||||||.||.||||.|
|.||||.||.||||||||.||.||||.|
|......||.||||||||.||......|
|.||||.||..........||.||||.|
|.||||.||.||||||||.||.||||.|
|.||......||||||||......||.|
|.||.||.||||||||||||.||.||.|
|.||.||.||||||||||||.||.||.|
|.||.||..............||.||.|
|.||.||..||||..||||..||.||.|
|.||.|||.||||..||||.|||.||.|
|.||.|||.||||..||||.|||.||.|
|........||||..||||........|
|.||||||.||||..||||.||||||.|
|.||||||.||||..||||.||||||.|
|..........................|
||||||||||||||||||||||||||||
