
||||||||||||||||||||||||||||
|..........................|
|.||||||.||.||||.||.||||||.|
|.||||||.||.||||.||.||||||.|
|.||||||....||||....||||||.|
|.||||||.||||||||||.||||||.|
|.....||.||||||||||.||.....|
|.|||.||............||.|||.|
|.|||.||.||||||||||.||.|||.|
|.|||....||||||||||....|||.|
|.|||.||.||||||||||.||.|||.|
|.|||.||............||.|||.|
|.|||.|||.||||||||.|||.|||.|
|.|||.|||.||||||||.|||.|||.|
|.........||||||||.........|
|.|||||||.||||||||.|||||||.|
|.|||||||.||||||||.|||||||.|
|..........................|
|.||||||.||.||||.||.||||||.|
|.||||||.||.||||.||.||||||.|
|.||||||.||.||||.||.||||||.|
|.|||....||..||..||....|||.|
|.....||.|||.||.|||.||.....|
|.||||||.|||.||.|||.||||||.|
|.||||.......||.......||||.|
|.||||.|||||.||.|||||.||||.|
|.||||.|||||....|||||.||||.|
|.||||.|||||.||.|||||.||||.|
|.||||.|||||.||.|||||.||||.|
|..........................|
||||||||||||||||||||||||||||
