
||||||||||||||||||||||||||||
|..........................|
|.||||.|||.||||||.|||.||||.|
|.||||.|||.||||||.|||.||||.|
|.||||.||...||||...||.||||.|
|.||||.||.||||||||.||.||||.|
|.........||||||||.........|
|.||.||||..........||||.||.|
|.||.||||.||||||||.||||.||.|
|.||.||||.||||||||.||||.||.|
|.||.||||.||||||||.||||.||.|
|.....|||..........|||.....|
|.|||.|||.||||||||.|||.|||.|
|.|||.....||||||||.....|||.|
|.|||||||.||||||||.|||||||.|
|.|||||||.||||||||.|||||||.|
|.........||||||||.........|
|.||.||||..........||||.||.|
|.||.||||.||||||||.||||.||.|
|.||.||...||||||||...||.||.|
|.||.||..............||.||.|
|.||.||||||.||||.||||||.||.|
|.||.||||||.||||.||||||.||.|
|...........||||...........|
|.|||||||||.||||.|||||||||.|
|.|||||||||.||||.|||||||||.|
|...........||||...........|
|.||||||.||.||||.||.||||||.|
|.||||||.||.||||.||.||||||.|
|..........................|
||||||||||||||||||||||||||||
