
||||||||||||||||||||||||||||
|..........................|
|.||.||.|||||..|||||.||.||.|
|.||.||.|||||..|||||.||.||.|
|.||....|||||..|||||....||.|
|.||.||..............||.||.|
|....||.||.||||||.||.||....|
|.|||||.||.||||||.||.|||||.|
|.|||||.....||||.....|||||.|
|....||...||||||||...||....|
|.||.||||.||||||||.||||.||.|
|.||.||||..........||||.||.|
|.||......||||||||......||.|
|.||.||||.||||||||.||||.||.|
|.||.||||.||||||||.||||.||.|
|.||.||||.||||||||.||||.||.|
|.||.||||.||||||||.||||.||.|
|..........................|
|.||||||.||.||||.||.||||||.|
|.||||||.||.||||.||.||||||.|
|.||||||.||.||||.||.||||||.|
|........||..||..||........|
|.||.|||.|||.||.|||.|||.||.|
|.||.|||.|||.||.|||.|||.||.|
|.||.|||............|||.||.|
|.||.|||.||||||||||.|||.||.|
|.||.....||||||||||.....||.|
|.||.|||.||||||||||.|||.||.|
|.||.|||.||||||||||.|||.||.|
|..........................|
||||||||||||||||||||||||||||
