
||||||||||||||||||||||||||||
|..........................|
|.||||||.||||||||||.||||||.|
|.||||||.||||||||||.||||||.|
|.||||||.||||||||||.||||||.|
|....|||............|||....|
|.||.|||.||||..||||.|||.||.|
|.||.|||.||||..||||.|||.||.|
|........||||..||||........|
|.||||.||||||..||||||.||||.|
|.||||.||||||..||||||.||||.|
|.||||.||..........||.||||.|
|.||||.||.||||||||.||.||||.|
|.........||||||||.........|
|.|||||||.||||||||.|||||||.|
|.|||||||.||||||||.|||||||.|
|.|||||||.||||||||.|||||||.|
|.|||||||..........|||||||.|
|.||||....|||..|||....||||.|
|......||.|||..|||.||......|
|.||||.||.|||..|||.||.||||.|
|.||||.||.|||..|||.||.||||.|
|.||||.||.||....||.||.||||.|
|.||||.||.||....||.||.||||.|
|..........................|
|.||||||||.||..||.||||||||.|
|.||||||||.||||||.||||||||.|
|.||||||||.||||||.||||||||.|
|.||||||||.||||||.||||||||.|
|..........................|
||||||||||||||||||||||||||||
