
||||||||||||||||||||||||||||
|..........................|
|.||||||||.||||||.||||||||.|
|.||||||||.||||||.||||||||.|
|.||||||||.||||||.||||||||.|
|..........||||||..........|
|.|||||||..........|||||||.|
|.|||||||.|||..|||.|||||||.|
|.|||||||.|||..|||.|||||||.|
|.|||||||.|||..|||.|||||||.|
|.........|||..|||.........|
|.|||||||..........|||||||.|
|.|||||||.||||||||.|||||||.|
|.|||||||.||||||||.|||||||.|
|.|||.....||||||||.....|||.|
|.|||.|||.||||||||.|||.|||.|
|.....|||.||||||||.|||.....|
|.|||||||..........|||||||.|
|.|||||||.||.||.||.|||||||.|
|.........||.||.||.........|
|.|||.||.||..||..||.||.|||.|
|.|||.||.||......||.||.|||.|
|.|||.||.||||..||||.||.|||.|
|.....||...||||||...||.....|
|.||||||||.||||||.||||||||.|
|.||||||||.||..||.||||||||.|
|..........||..||..........|
|.||||||||.||..||.||||||||.|
|.||||||||.||..||.||||||||.|
|..........................|
||||||||||||||||||||||||||||
