
||||||||||||||||||||||||||||
|..........................|
|.|||.|||||.||||.|||||.|||.|
|.|||.|||||.||||.|||||.|||.|
|.|||.|||||......|||||.|||.|
|.|||.|||||.||||.|||||.|||.|
|.|||.......||||.......|||.|
|.......|||..||..|||.......|
|.|||||.||||.||.||||.|||||.|
|.|||||...||.||.||...|||||.|
|.|||||||.||.||.||.|||||||.|
|.|||||||..........|||||||.|
|.........||||||||.........|
|.||.||||.||||||||.||||.||.|
|.||.||||.||||||||.||||.||.|
|.||.||||.||||||||.||||.||.|
|.||......||||||||......||.|
|.|||||||..........|||||||.|
|.|||||||.||||||||.|||||||.|
|.........||||||||.........|
|.||||||.||||||||||.||||||.|
|.||||||.||||||||||.||||||.|
|..........................|
|.|||.||||.||||||.||||.|||.|
|.|||.||||.||||||.||||.|||.|
|.|||.||||..||||..||||.|||.|
|.|||.|||||.||||.|||||.|||.|
|.|||.|||||.||||.|||||.|||.|
|.|||.|||||.||||.|||||.|||.|
|..........................|
||||||||||||||||||||||||||||
