
||||||||||||||||||||||||||||
|..........................|
|.||.||||.||||||||.||||.||.|
|.||.||||.||||||||.||||.||.|
|....||||.||||||||.||||....|
|.||||....||||||||....||||.|
|.||||.||..........||.||||.|
|......||.||||||||.||......|
|.||||.||.||||||||.||.||||.|
|.||||.||.||||||||.||.||||.|
|.||||.||.||||||||.||.||||.|
|.||||.||..........||.||||.|
|.||||....||||||||....||||.|
|.||||.||.||||||||.||.||||.|
|......||.||||||||.||......|
|.||.||||.||||||||.||||.||.|
|.||.||||.||||||||.||||.||.|
|.||.||..............||.||.|
|.||.||.||||||||||||.||.||.|
|.||.||.||||||||||||.||.||.|
|.||....||||||||||||....||.|
|.||.||..............||.||.|
|.||.||||.||.||.||.||||.||.|
|.||.||||.||.||.||.||||.||.|
|.....|||.||.||.||.|||.....|
|.|||.|||.||.||.||.|||.|||.|
|.|||........||........|||.|
|.|||.||||||.||.||||||.|||.|
|.|||.||||||.||.||||||.|||.|
|..........................|
||||||||||||||||||||||||||||
