
||||||||||||||||||||||||||||
|..........................|
|.|||.||||||||||||||||.|||.|
|.|||.||||||||||||||||.|||.|
|.|||..................|||.|
|.|||.||||||||||||||||.|||.|
|.....||||||||||||||||.....|
|.|||...||........||...|||.|
|.|||||.||.||||||.||.|||||.|
|.|||||.||.||||||.||.|||||.|
|..........||||||..........|
|.|||||||..........|||||||.|
|.|||||||.||||||||.|||||||.|
|.|||.....||||||||.....|||.|
|.|||.|||.||||||||.|||.|||.|
|.....|||.||||||||.|||.....|
|.|||.|||.||||||||.|||.|||.|
|.|||..................|||.|
|.|||..|||||.||.|||||..|||.|
|......|||||.||.|||||......|
|.||||...|||.||.|||...||||.|
|.||||||............||||||.|
|.||||||||.||..||.||||||||.|
|.||||||||.||..||.||||||||.|
|.....||||.||..||.||||.....|
|.|||......||..||......|||.|
|.|||.||||.||..||.||||.|||.|
|.|||.||||.||..||.||||.|||.|
|.|||.||||.||..||.||||.|||.|
|..........................|
||||||||||||||||||||||||||||
