
||||||||||||||||||||||||||||
|..........................|
|.||||.||||||..||||||.||||.|
|.||||.||||||..||||||.||||.|
|.||||.||||||..||||||.||||.|
|.||||.||||||..||||||.||||.|
|.||||................||||.|
|.||||.|||||.||.|||||.||||.|
|......|||||.||.|||||......|
|.||||...|||.||.|||...||||.|
|.||||||.|||.||.|||.||||||.|
|.||||||............||||||.|
|.|||||||.||||||||.|||||||.|
|....||||.||||||||.||||....|
|.||.||||.||||||||.||||.||.|
|.||.||||.||||||||.||||.||.|
|.||......||||||||......||.|
|.||.||||..........||||.||.|
|.||.||||.||||||||.||||.||.|
|.||.||||.||||||||.||||.||.|
|......||.||||||||.||......|
|.||||....||||||||....||||.|
|.|||||||.||||||||.|||||||.|
|.|||||||.||||||||.|||||||.|
|..........................|
|.|||||.||||.||.||||.|||||.|
|.|||||.||||.||.||||.|||||.|
|.|||||.||||.||.||||.|||||.|
|.|||||.||||.||.||||.|||||.|
|..........................|
||||||||||||||||||||||||||||
