
||||||||||||||||||||||||||||
|..........................|
|.|||||||.||||||||.|||||||.|
|.|||||||.||||||||.|||||||.|
|.|||||||.||||||||.|||||||.|
|..........................|
|.||||.||||||..||||||.||||.|
|.||||.||||||..||||||.||||.|
|.||||................||||.|
|.||||.||||||..||||||.||||.|
|......||||||..||||||......|
|.||||.||..........||.||||.|
|.||||.||.||||||||.||.||||.|
|.||||.||.||||||||.||.||||.|
|.||||.||.||||||||.||.||||.|
|.........||||||||.........|
|.||||.||.||||||||.||.||||.|
|.||||.||..........||.||||.|
|.||||..||||.||.||||..||||.|
|.|||||.||||.||.||||.|||||.|
|.|||||.||||.||.||||.|||||.|
|.||....||||.||.||||....||.|
|.||.||.||||.||.||||.||.||.|
|....||......||......||....|
|.|||||.||||.||.||||.|||||.|
|.|||||.||||.||.||||.|||||.|
|.......||||.||.||||.......|
|.|||||.||||.||.||||.|||||.|
|.|||||.||||.||.||||.|||||.|
|..........................|
||||||||||||||||||||||||||||
