
||||||||||||||||||||||||||||
|..........................|
|.|||.||.||||..||||.||.|||.|
|.|||.||.||||..||||.||.|||.|
|.|||.||.||||..||||.||.|||.|
|.|||.||.||||..||||.||.|||.|
|.|||.||............||.|||.|
|.|||.||||.||||||.||||.|||.|
|.......||.||||||.||.......|
|.|||||.||.||||||.||.|||||.|
|.|||||.||.||||||.||.|||||.|
|.|||..................|||.|
|.|||.|||.||||||||.|||.|||.|
|.|||.|||.||||||||.|||.|||.|
|.|||.|||.||||||||.|||.|||.|
|.|||.|||.||||||||.|||.|||.|
|.........||||||||.........|
|.||.||||..........||||.||.|
|.||.||||.||.||.||.||||.||.|
|.||.|||..||.||.||..|||.||.|
|.||.|||.||......||.|||.||.|
|.||.....||.||||.||.....||.|
|.||.|||||..||||..|||||.||.|
|....|||||.||||||.|||||....|
|.||.|||||.||||||.|||||.||.|
|.||.|||||.||||||.|||||.||.|
|..........................|
|.|||||||||||..|||||||||||.|
|.|||||||||||..|||||||||||.|
|..........................|
||||||||||||||||||||||||||||
