
||||||||||||||||||||||||||||
|..........................|
|.|||.||.||||||||||.||.|||.|
|.|||.||.||||||||||.||.|||.|
|.|||....||||||||||....|||.|
|.||||||.||||||||||.||||||.|
|.||||||............||||||.|
|........||||||||||........|
|.|||.||.||||||||||.||.|||.|
|.|||.||.||||||||||.||.|||.|
|.|||.||.||||||||||.||.|||.|
|.|||..................|||.|
|.....|||.||||||||.|||.....|
|.||.||||.||||||||.||||.||.|
|.||.||||.||||||||.||||.||.|
|.||.||||.||||||||.||||.||.|
|.||.||||.||||||||.||||.||.|
|..........................|
|.||||||||.||||||.||||||||.|
|.||||||||.||||||.||||||||.|
|............||............|
|.||||.||.||.||.||.||.||||.|
|.||||.||.||....||.||.||||.|
|.||||.||.||||||||.||.||||.|
|.||||.||.||||||||.||.||||.|
|..........................|
|.||||||.||||..||||.||||||.|
|.||||||.||||..||||.||||||.|
|.||||||.||||..||||.||||||.|
|..........................|
||||||||||||||||||||||||||||
