
||||||||||||||||||||||||||||
|..........................|
|.||||.||.||||||||.||.||||.|
|.||||.||.||||||||.||.||||.|
|......||.||||||||.||......|
|.||||.||..........||.||||.|
|.||||.||.||||||||.||.||||.|
|.||||.||.||||||||.||.||||.|
|..........................|
|.|||||||||||..|||||||||||.|
|.|||||||||||..|||||||||||.|
|..........................|
|.|||||||.||||||||.|||||||.|
|.|||||||.||||||||.|||||||.|
|.||||....||||||||....||||.|
|.||||.||.||||||||.||.||||.|
|.||||.||.||||||||.||.||||.|
|......||..........||......|
|.||.|||||||.||.|||||||.||.|
|.||.|||||||.||.|||||||.||.|
|.||.|||||||.||.|||||||.||.|
|.||.........||.........||.|
|.||.||||||.||||.||||||.||.|
|.||.||||||.||||.||||||.||.|
|........||..||..||........|
|.|||.||.|||.||.|||.||.|||.|
|.|||.||..||.||.||..||.|||.|
|.|||.|||.||.||.||.|||.|||.|
|.|||.|||.||.||.||.|||.|||.|
|..........................|
||||||||||||||||||||||||||||
