
||||||||||||||||||||||||||||
|..........................|
|.|||||.||.||||||.||.|||||.|
|.|||||.||.||||||.||.|||||.|
|.|||||.||...||...||.|||||.|
|.......||||.||.||||.......|
|.|||||.||||.||.||||.|||||.|
|.|||||......||......|||||.|
|....||.||||....||||.||....|
|.||.||.||||||||||||.||.||.|
|.||.||...||||||||...||.||.|
|.||.||||..........||||.||.|
|.||.||||.||||||||.||||.||.|
|.||......||||||||......||.|
|.|||.|||.||||||||.|||.|||.|
|.|||.|||.||||||||.|||.|||.|
|.|||.|||.||||||||.|||.|||.|
|.....||............||.....|
|.||||||.||||||||||.||||||.|
|.||||||.||||||||||.||||||.|
|........||......||........|
|.||||||.||.||||.||.||||||.|
|.||||||.||.||||.||.||||||.|
|....|||.||.||||.||.|||....|
|.||.|||....||||....|||.||.|
|.||.|||.||......||.|||.||.|
|.||.....||||||||||.....||.|
|.||.|||.||||||||||.|||.||.|
|.||.|||.||||||||||.|||.||.|
|.||.||.|||||..|||||.||.||.|
|.||.||.|||||..|||||.||.||.|
|.||....|||||..|||||....||.|
|.||.||..............||.||.|
|....||.||.||||||.||.||....|
|.|||||.||.||||||.||.|||||.|
|.|||||.....||||.....|||||.|
|....||...||||||||...||....|
|.||.||||.||||||||.||||.||.|
|.||.||||..........||||.||.|
|.||......||||||||......||.|
|.||.||||.||||||||.||||.||.|
|.||.||||.||||||||.||||.||.|
|....||||.||||||||.||||....|
|.||||....||||||||....||||.|
|.||||.||..........||.||||.|
|......||.||||||||.||......|
|.||||.||.||||||||.||.||||.|
|.||||.||.||||||||.||.||||.|
|.||||.||.||||||||.||.||||.|
|.||||.||..........||.||||.|
|.||||....||||||||....||||.|
|.||||.||.||||||||.||.||||.|
|......||.||||||||.||......|
|.||.||||.||||||||.||||.||.|
|.||.||||.||||||||.||||.||.|
|.||.||..............||.||.|
|.||.||.||||||||||||.||.||.|
|.||.||.||||||||||||.||.||.|
|.||....||||||||||||....||.|
|.||.||..............||.||.|
|.||.||||.||.||.||.||||.||.|
|.||.||||.||.||.||.||||.||.|
|.....|||.||.||.||.|||.....|
|.|||.|||.||.||.||.|||.|||.|
|.|||........||........|||.|
|.|||.||||||.||.||||||.|||.|
|.|||.||||||.||.||||||.|||.|
|..........................|
||||||||||||||||||||||||||||
