
||||||||||||||||||||||||||||
|..........................|
|.|||||.|||.||||.|||.|||||.|
|.|||||.|||.||||.|||.|||||.|
|.|||||.|||......|||.|||||.|
|.||....|||.||||.|||....||.|
|....||.....||||.....||....|
|.|||||||||.||||.|||||||||.|
|.|||||||||.||||.|||||||||.|
|......||||.||||.||||......|
|.||||.||||.||||.||||.||||.|
|.||||................||||.|
|.||||.||.||||||||.||.||||.|
|.||||.||.||||||||.||.||||.|
|.........||||||||.........|
|.|||||||.||||||||.|||||||.|
|.|||||||.||||||||.|||||||.|
|.||||||............||||||.|
|........||||..||||........|
|.||||||.||||..||||.||||||.|
|.||||||.||||..||||.||||||.|
|.||||||............||||||.|
|........||.||||.||........|
|.||.|||.||.||||.||.|||.||.|
|.||.|||.||..||..||.|||.||.|
|.||.|||.|||.||.|||.|||.||.|
|.....||.|||.||.|||.||.....|
|.|||.||.|||.||.|||.||.|||.|
|.|||.||.|||.||.|||.||.|||.|
|..........................|
||||||||||||||||||||||||||||
