
||||||||||||||||||||||||||||
|..........................|
|.|||.|||||||..|||||||.|||.|
|.|||.|||||||..|||||||.|||.|
|.|||....||||..||||....|||.|
|.|||.||||........||||.|||.|
|.|||.||||.||||||.||||.|||.|
|..........||||||..........|
|.||.|||||.||||||.|||||.||.|
|.||.|||||.||||||.|||||.||.|
|.||....||.||||||.||....||.|
|.|||||..............|||||.|
|.|||||||.||||||||.|||||||.|
|.|||||||.||||||||.|||||||.|
|.||||....||||||||....||||.|
|.||...||.||||||||.||...||.|
|....||||.||||||||.||||....|
|.|||||..............|||||.|
|.||||..|||.||||.|||..||||.|
|.||||.||||.||||.||||.||||.|
|.||||.||||.||||.||||.||||.|
|.||||......||||......||||.|
|......||||......||||......|
|.||||.||||.||||.||||.||||.|
|.||||.||||.||||.||||.||||.|
|.||||.||||.||||.||||.||||.|
|..........................|
|.|||||||.||||||||.|||||||.|
|.|||||||.||||||||.|||||||.|
|..........................|
||||||||||||||||||||||||||||
