
||||||||||||||||||||||||||||
|..........................|
|.||||.||||||..||||||.||||.|
|.||||.||||||..||||||.||||.|
|.||||................||||.|
|.||||.||||.||||.||||.||||.|
|......||||.||||.||||......|
|.||||.||||.||||.||||.||||.|
|.||||.||..........||.||||.|
|.||||.||.||||||||.||.||||.|
|.||||.||.||||||||.||.||||.|
|..........................|
|.|||||||.||||||||.|||||||.|
|.|||||||.||||||||.|||||||.|
|.........||||||||.........|
|.|||.|||.||||||||.|||.|||.|
|.|||.|||.||||||||.|||.|||.|
|.|||.|||..........|||.|||.|
|.....||||||.||.||||||.....|
|.|||.||||||.||.||||||.|||.|
|.|||........||........|||.|
|.|||.||||||.||.||||||.|||.|
|.|||.||||||....||||||.|||.|
|.......||||.||.||||.......|
|.|||||......||......|||||.|
|.|||||.||||.||.||||.|||||.|
|....||.||||.||.||||.||....|
|.||.||.||||.||.||||.||.||.|
|.||.||.||||.||.||||.||.||.|
|..........................|
||||||||||||||||||||||||||||
