
||||||||||||||||||||||||||||
|..........................|
|.||.|||||.||||||.|||||.||.|
|.||.|||||.||||||.|||||.||.|
|.||.|||||.||||||.|||||.||.|
|.||.|||||.||||||.|||||.||.|
|.||.........||.........||.|
|.||||||.|||....|||.||||||.|
|.||||||.||||..||||.||||||.|
|.........|||..|||.........|
|.|||.|||.|||..|||.|||.|||.|
|.|||.|||..........|||.|||.|
|.|||.|||.||||||||.|||.|||.|
|.|||.|||.||||||||.|||.|||.|
|.|||.|||.||||||||.|||.|||.|
|.|||.|||.||||||||.|||.|||.|
|.||......||||||||......||.|
|....||||..........||||....|
|.|||||||..||..||..|||||||.|
|.|||||....||..||....|||||.|
|.......||.||..||.||.......|
|.||||||||.||||||.||||||||.|
|.|||||||....||....|||||||.|
|.........||.||.||.........|
|.||.||.||||.||.||||.||.||.|
|.||.||.|||..||..|||.||.||.|
|....||.|||.||||.|||.||....|
|.|||||.|||.||||.|||.|||||.|
|.|||||.|||.||||.|||.|||||.|
|..........................|
||||||||||||||||||||||||||||
