
||||||||||||||||||||||||||||
|..........................|
|.||.||.||||.||.||||.||.||.|
|.||.||.||||.||.||||.||.||.|
|.||....||||.||.||||....||.|
|.|||||..|||.||.|||..|||||.|
|.||||||.|||....|||.||||||.|
|.....||.|||.||.|||.||.....|
|.|||........||........|||.|
|.|||.||..||||||||..||.|||.|
|.|||.|||.||||||||.|||.|||.|
|.|||.|||..........|||.|||.|
|.....|||.||||||||.|||.....|
|.|||.....||||||||.....|||.|
|.||||.||.||||||||.||.||||.|
|.||||.||.||||||||.||.||||.|
|.||||.||.||||||||.||.||||.|
|......||..........||......|
|.||||.||||.||||.||||.||||.|
|.||||.||||.||||.||||.||||.|
|......||||.||||.||||......|
|.||||................||||.|
|.||||.||||||||||||||.||||.|
|.||||.||||||||||||||.||||.|
|.||||......||||......||||.|
|.......|||.||||.|||.......|
|.|||||.|||.||||.|||.|||||.|
|.|||||.|||.||||.|||.|||||.|
|.|||||.|||.||||.|||.|||||.|
|..........................|
||||||||||||||||||||||||||||
