
||||||||||||||||||||||||||||
|..........................|
|.|||.||.||.||||.||.||.|||.|
|.|||.||.||.||||.||.||.|||.|
|.....||.||.||||.||.||.....|
|.||||||.||......||.||||||.|
|.||||...||.||||.||...||||.|
|.||||.||||.||||.||||.||||.|
|......||||.||||.||||......|
|.||||..|||.||||.|||..||||.|
|.|||||.|||.||||.|||.|||||.|
|.|||||..............|||||.|
|.|||||||.||||||||.|||||||.|
|.|||..||.||||||||.||..|||.|
|.........||||||||.........|
|.|||||||.||||||||.|||||||.|
|.|||||||.||||||||.|||||||.|
|.||||||............||||||.|
|........||||||||||........|
|.||.||..||||||||||..||.||.|
|.||.|||.||||||||||.|||.||.|
|.||.|||............|||.||.|
|.||.|||.||||||||||.|||.||.|
|.....||.||||||||||.||.....|
|.|||..................|||.|
|.|||.|||||.||||.|||||.|||.|
|.|||.|||||.||||.|||||.|||.|
|.|||.|||||.||||.|||||.|||.|
|.|||.|||||.||||.|||||.|||.|
|..........................|
||||||||||||||||||||||||||||
