
||||||||||||||||||||||||||||
|..........................|
|.||.|||||.||||||.|||||.||.|
|.||.|||||.||||||.|||||.||.|
|.||...|||.||||||.|||...||.|
|.||||.||..||..||..||.||||.|
|.||||.||.|||..|||.||.||||.|
|......||.|||..|||.||......|
|.||||................||||.|
|.||||.||||||..||||||.||||.|
|.||||.||||||..||||||.||||.|
|.||||................||||.|
|.||||.||.||||||||.||.||||.|
|.||||.||.||||||||.||.||||.|
|......||.||||||||.||......|
|.||||.||.||||||||.||.||||.|
|.||||....||||||||....||||.|
|.||||||............||||||.|
|.||||||.||||..||||.||||||.|
|........||||..||||........|
|.||.|||.||||..||||.|||.||.|
|.||.|||.||||..||||.|||.||.|
|.||.......||..||.......||.|
|.||.||.||.||..||.||.||.||.|
|.||.||.||.||..||.||.||.||.|
|.||.||..............||.||.|
|....||..||.||||.||..||....|
|.||.||||||.||||.||||||.||.|
|.||.||||||.||||.||||||.||.|
|..........................|
||||||||||||||||||||||||||||
