
||||||||||||||||||||||||||||
|..........................|
|.|||.||.||||..||||.||.|||.|
|.|||.||.||||..||||.||.|||.|
|.....||.||||..||||.||.....|
|.|||.||.||||..||||.||.|||.|
|.|||.||.||||..||||.||.|||.|
|.|||.||.||......||.||.|||.|
|.|||.||.||..||..||.||.|||.|
|.........||.||.||.........|
|.||.||||.||.||.||.||||.||.|
|.||.||||..........||||.||.|
|....||||.||||||||.||||....|
|.|||||||.||||||||.|||||||.|
|.|||||||.||||||||.|||||||.|
|.|||||||.||||||||.|||||||.|
|.|||||||.||||||||.|||||||.|
|..........................|
|.|||||||||.||||.|||||||||.|
|.|||||||||.||||.|||||||||.|
|......||||.||||.||||......|
|.||||................||||.|
|.||||||.||||||||||.||||||.|
|.||||||.||||||||||.||||||.|
|.||||....||....||....||||.|
|......||.||.||.||.||......|
|.|||||||.||.||.||.|||||||.|
|.|||||||.||.||.||.|||||||.|
|.|||||||.||.||.||.|||||||.|
|..........................|
||||||||||||||||||||||||||||
