
||||||||||||||||||||||||||||
|..........................|
|.||||.||||||..||||||.||||.|
|.||||.||||||..||||||.||||.|
|.||||.||||||..||||||.||||.|
|.||....................||.|
|.||.||||||.||||.||||||.||.|
|.||.||||||.||||.||||||.||.|
|.||........||||........||.|
|.||.||||||.||||.||||||.||.|
|.||.||||||.||||.||||||.||.|
|..........................|
|.||||.||.||||||||.||.||||.|
|.||||.||.||||||||.||.||||.|
|.||||.||.||||||||.||.||||.|
|.||||.||.||||||||.||.||||.|
|.|||.....||||||||.....|||.|
|.|||.|||..........|||.|||.|
|.....|||.||||||||.|||.....|
|.|||.||..||||||||..||.|||.|
|.|||.||....||||....||.|||.|
|.|||.|||||.||||.|||||.|||.|
|.|||.|||||.||||.|||||.|||.|
|...........||||...........|
|.||.||.|||.||||.|||.||.||.|
|.||.||.|||......|||.||.||.|
|....||.....||||.....||....|
|.|||||||||.||||.|||||||||.|
|.|||||||||.||||.|||||||||.|
|..........................|
||||||||||||||||||||||||||||
