
||||||||||||||||||||||||||||
|..........................|
|.||||.||.||||||||.||.||||.|
|.||||.||.||||||||.||.||||.|
|.||||.||..........||.||||.|
|.||||.||.|||..|||.||.||||.|
|......||.|||..|||.||......|
|.||||.....||..||.....||||.|
|.||||..||.||..||.||..||||.|
|.|||...||.||..||.||...|||.|
|.|||.||||.||..||.||||.|||.|
|.....|||..........|||.....|
|.|||||||.||||||||.|||||||.|
|.|||||||.||||||||.|||||||.|
|.........||||||||.........|
|.|||||||.||||||||.|||||||.|
|.|||||||.||||||||.|||||||.|
|.|||||..............|||||.|
|.||||..|||||..|||||..||||.|
|......||||||..||||||......|
|.||||.||||||..||||||.||||.|
|.||||................||||.|
|.||||.||.||||||||.||.||||.|
|.||||.||.||||||||.||.||||.|
|.||||.||.||||||||.||.||||.|
|..........................|
|.||.||||.||||||||.||||.||.|
|.||.||||.||||||||.||||.||.|
|.||.||||.||||||||.||||.||.|
|..........................|
||||||||||||||||||||||||||||
