
||||||||||||||||||||||||||||
|..........................|
|.|||.||||||||||||||||.|||.|
|.|||.||||||||||||||||.|||.|
|.|||.||............||.|||.|
|.||.....||||..||||.....||.|
|....||||||||..||||||||....|
|.||.||||||||..||||||||.||.|
|.||....................||.|
|.||.||||.||||||||.||||.||.|
|.||.||||.||||||||.||||.||.|
|.||.||||..........||||.||.|
|.||.||||.||||||||.||||.||.|
|.||.||||.||||||||.||||.||.|
|.||.||||.||||||||.||||.||.|
|.||.||||.||||||||.||||.||.|
|.||.||||.||||||||.||||.||.|
|..........................|
|.|||.||||||||||||||||.|||.|
|.|||.||||||||||||||||.|||.|
|.|||.||||........||||.|||.|
|.|||.||||.||||||.||||.|||.|
|.|||......||||||......|||.|
|......|||.||||||.|||......|
|.||||.|||.||||||.|||.||||.|
|.||||.||..........||.||||.|
|.||||.||.||||||||.||.||||.|
|.||||.||.||||||||.||.||||.|
|.||||.||.||||||||.||.||||.|
|..........................|
||||||||||||||||||||||||||||
