
||||||||||||||||||||||||||||
|..........................|
|.||.||||||.||||.||||||.||.|
|.||.||||||.||||.||||||.||.|
|.||.||||||.||||.||||||.||.|
|....||||||.||||.||||||....|
|.||....................||.|
|.||||.||||||..||||||.||||.|
|.||||.||||||..||||||.||||.|
|.||||.||||||..||||||.||||.|
|.||||.||||||..||||||.||||.|
|..........................|
|.|||||||.||||||||.|||||||.|
|.|||||||.||||||||.|||||||.|
|.........||||||||.........|
|.|||.|||.||||||||.|||.|||.|
|.|||.|||.||||||||.|||.|||.|
|.|||.|||..........|||.|||.|
|.|||.|||.||||||||.|||.|||.|
|.|||.||..||||||||..||.|||.|
|.|||.||.||||||||||.||.|||.|
|........||||||||||........|
|.||||||............||||||.|
|.||||||..||||||||..||||||.|
|.||||....||||||||....||||.|
|.||||.||...||||...||.||||.|
|.||||.||||.||||.||||.||||.|
|.||||.||||.||||.||||.||||.|
|.||||.||||.||||.||||.||||.|
|..........................|
||||||||||||||||||||||||||||
