
||||||||||||||||||||||||||||
|..........................|
|.|||.||.||||||||||.||.|||.|
|.|||.||.||||||||||.||.|||.|
|.|||.||.||||||||||.||.|||.|
|.|||.||.||||||||||.||.|||.|
|.|||.||............||.|||.|
|.....||.||||||||||.||.....|
|.||||||.||||||||||.||||||.|
|.||||||.||||||||||.||||||.|
|........||||||||||........|
|.||||................||||.|
|.||||.||.||||||||.||.||||.|
|.||||.||.||||||||.||.||||.|
|.........||||||||.........|
|.|||||||.||||||||.|||||||.|
|.|||||||.||||||||.|||||||.|
|.|||||..............|||||.|
|.|||||.||.||||||.||.|||||.|
|.|||||.||.||||||.||.|||||.|
|.......||.||||||.||.......|
|.|||||.||........||.|||||.|
|.|||||.||.||..||.||.|||||.|
|.|||||.||.||..||.||.|||||.|
|.||....||.||..||.||....||.|
|.||.||.||.||..||.||.||.||.|
|....||.||.||..||.||.||....|
|.|||||.||.||..||.||.|||||.|
|.|||||.||.||..||.||.|||||.|
|..........................|
||||||||||||||||||||||||||||
