
||||||||||||||||||||||||||||
|..........................|
|.|||||.||||.||.||||.|||||.|
|.|||||.||||.||.||||.|||||.|
|.|||||.||||....||||.|||||.|
|.|||........||........|||.|
|.|||.||||||.||.||||||.|||.|
|.|||.||||||.||.||||||.|||.|
|............||............|
|.||.||||.||.||.||.||||.||.|
|.||.||||.||.||.||.||||.||.|
|.||.||||..........||||.||.|
|.||.||||.||||||||.||||.||.|
|.||......||||||||......||.|
|.||.||||.||||||||.||||.||.|
|....||||.||||||||.||||....|
|.||.||||.||||||||.||||.||.|
|.||.||||..........||||.||.|
|.........||||||||.........|
|.|||.|||.||||||||.|||.|||.|
|.|||.|||.||....||.|||.|||.|
|.|||.|||.||.||.||.|||.|||.|
|.|||.....||.||.||.....|||.|
|.|||.|||.||.||.||.|||.|||.|
|.....|||....||....|||.....|
|.|||.|||.||.||.||.|||.|||.|
|.|||.|||.||.||.||.|||.|||.|
|.|||.|||.||.||.||.|||.|||.|
|.|||.|||.||.||.||.|||.|||.|
|..........................|
||||||||||||||||||||||||||||
