
||||||||||||||||||||||||||||
|..........................|
|.|||.||.||||||||||.||.|||.|
|.|||.||.||||||||||.||.|||.|
|.|||.||.||||||||||.||.|||.|
|.|||.||..||||||||..||.|||.|
|.|||.|||.||||||||.|||.|||.|
|.|||.|||..........|||.|||.|
|.........||||||||.........|
|.|||||||.||||||||.|||||||.|
|.|||||||.||||||||.|||||||.|
|.|||..................|||.|
|.|||.|||.||||||||.|||.|||.|
|.....|||.||||||||.|||.....|
|.|||||||.||||||||.|||||||.|
|.|||||||.||||||||.|||||||.|
|.........||||||||.........|
|.|||||||..........|||||||.|
|.|||||||.||.||.||.|||||||.|
|.........||.||.||.........|
|.||||||.|||.||.|||.||||||.|
|.||||||.||......||.||||||.|
|.....||....||||....||.....|
|.|||.||.||.||||.||.||.|||.|
|.|||.||.||||||||||.||.|||.|
|.|||......||||||......|||.|
|.|||.||||.||||||.||||.|||.|
|.|||.||||.||||||.||||.|||.|
|.|||.||||.||||||.||||.|||.|
|..........................|
||||||||||||||||||||||||||||
