
||||||||||||||||||||||||||||
|..........................|
|.|||.|||||.||||.|||||.|||.|
|.|||.|||||.||||.|||||.|||.|
|.|||.|||...||||...|||.|||.|
|.|||.|||.||||||||.|||.|||.|
|.........||||||||.........|
|.|||||||.||||||||.|||||||.|
|.|||||||.||||||||.|||||||.|
|.........||||||||.........|
|.||||.||.||||||||.||.||||.|
|.||||.||..........||.||||.|
|.||||.||.||||||||.||.||||.|
|.||||.||.||||||||.||.||||.|
|.........||||||||.........|
|.|||||||.||||||||.|||||||.|
|.|||||||.||||||||.|||||||.|
|.||||................||||.|
|......|||.||||||.|||......|
|.||||||||.||||||.||||||||.|
|.||||||||.||||||.||||||||.|
|.|||......||||||......|||.|
|.....||||.||||||.||||.....|
|.||||||||........||||||||.|
|.||||||||.||||||.||||||||.|
|.||||.....||||||.....||||.|
|......|||...||...|||......|
|.||||||||||.||.||||||||||.|
|.||||||||||.||.||||||||||.|
|..........................|
||||||||||||||||||||||||||||
