
||||||||||||||||||||||||||||
|..........................|
|.||||.|||.||||||.|||.||||.|
|.||||.|||.||||||.|||.||||.|
|.||||.|||..||||..|||.||||.|
|.||||.||||.||||.||||.||||.|
|.||||...||.||||.||...||||.|
|...........||||...........|
|.|||.|||||.||||.|||||.|||.|
|.|||.|||||.||||.|||||.|||.|
|.|||.|||||.||||.|||||.|||.|
|.|||..................|||.|
|.....|||.||||||||.|||.....|
|.|||.|||.||||||||.|||.|||.|
|.|||.|||.||||||||.|||.|||.|
|.|||.|||.||||||||.|||.|||.|
|......||.||||||||.||......|
|.||||................||||.|
|.||||.||||.||||.||||.||||.|
|.||||.||||.||||.||||.||||.|
|.||||.||||.||||.||||.||||.|
|..........................|
|.|||||||.|||..|||.|||||||.|
|.|||||||.|||..|||.|||||||.|
|......||.||||||||.||......|
|.||||.||.||||||||.||.||||.|
|.||||.||..........||.||||.|
|.||||.||.||||||||.||.||||.|
|.||||.||.||||||||.||.||||.|
|..........................|
||||||||||||||||||||||||||||
