
||||||||||||||||||||||||||||
|..........................|
|.|||||.||||||||||||.|||||.|
|.|||||.||||||||||||.|||||.|
|.|||||.||||||||||||.|||||.|
|..........................|
|.||.||.|||||..|||||.||.||.|
|.||.||.|||||..|||||.||.||.|
|....||..||||..||||..||....|
|.||.|||..|||..|||..|||.||.|
|.||..|||.|||..|||.|||..||.|
|.|||.|||..........|||.|||.|
|.|||.....||||||||.....|||.|
|.|||.|||.||||||||.|||.|||.|
|.....|||.||||||||.|||.....|
|.|||.|||.||||||||.|||.|||.|
|.|||.|||.||||||||.|||.|||.|
|.|||.|||..........|||.|||.|
|.|||.|||.||||||||.|||.|||.|
|.........||||||||.........|
|.||||.||.|||..|||.||.||||.|
|.||||.||..........||.||||.|
|.||||.||||.||||.||||.||||.|
|.||||.||||.||||.||||.||||.|
|.||||.||||.||||.||||.||||.|
|......||||.||||.||||......|
|.||||......||||......||||.|
|.|||||.|||.||||.|||.|||||.|
|.|||||.|||.||||.|||.|||||.|
|..........................|
||||||||||||||||||||||||||||
