
||||||||||||||||||||||||||||
|..........................|
|.|||.|||.||||||||.|||.|||.|
|.|||.|||.||||||||.|||.|||.|
|.|||.|||.||||||||.|||.|||.|
|.|||.|||..........|||.|||.|
|.|||.|||.|||..|||.|||.|||.|
|.|||.....|||..|||.....|||.|
|.....|||.|||..|||.|||.....|
|.||.||||.|||..|||.||||.||.|
|.||.||||.|||..|||.||||.||.|
|.||.||||..........||||.||.|
|.||.||||.||||||||.||||.||.|
|.||.||||.||||||||.||||.||.|
|.||......||||||||......||.|
|.||.||||.||||||||.||||.||.|
|.||.||||.||||||||.||||.||.|
|.||.||||..........||||.||.|
|.||.||||..||||||..||||.||.|
|..........||||||..........|
|.|||||.||...||...||.|||||.|
|.|||||.||||.||.||||.|||||.|
|.|||||.||||.||.||||.|||||.|
|........|||.||.|||........|
|.||||||.|||.||.|||.||||||.|
|.||||||............||||||.|
|.||||||.||||..||||.||||||.|
|.||||||.||||..||||.||||||.|
|.||||||.||||..||||.||||||.|
|..........................|
||||||||||||||||||||||||||||
