
||||||||||||||||||||||||||||
|..........................|
|.||.||.||.||||||.||.||.||.|
|.||.||.||.||||||.||.||.||.|
|.||.||.||.||||||.||.||.||.|
|.||.||.||.||||||.||.||.||.|
|.||.||.||........||.||.||.|
|.||.||....||||||....||.||.|
|.||.|||||.||||||.|||||.||.|
|....|||||.||||||.|||||....|
|.||....||.||||||.||....||.|
|.||.||..............||.||.|
|.||.||||.||||||||.||||.||.|
|.||.||||.||||||||.||||.||.|
|.||.||||.||||||||.||||.||.|
|.||.||||.||||||||.||||.||.|
|.........||||||||.........|
|.|||.|||..........|||.|||.|
|.|||.|||.||||||||.|||.|||.|
|.|||.||..||||||||..||.|||.|
|.|||.||....||||....||.|||.|
|.|||.|||||.||||.|||||.|||.|
|.|||.|||||......|||||.|||.|
|...........||||...........|
|.||||||||||||||||||||||||.|
|.|||||||||||..|||||||||||.|
|..........................|
|.||||||.||||||||||.||||||.|
|.||||||.||||||||||.||||||.|
|..........................|
||||||||||||||||||||||||||||
