
||||||||||||||||||||||||||||
|..........................|
|.|||.||.|||.||.|||.||.|||.|
|.|||.||.|||.||.|||.||.|||.|
|.|||....|||.||.|||....|||.|
|.||||||.|||.||.|||.||||||.|
|.||||||.|||.||.|||.||||||.|
|.........||.||.||.........|
|.|||.|||.||.||.||.|||.|||.|
|.|||.|||.||.||.||.|||.|||.|
|.|||.|||.||.||.||.|||.|||.|
|.|||.|||..........|||.|||.|
|.|||.|||.||||||||.|||.|||.|
|.||......||||||||......||.|
|....||||.||||||||.||||....|
|.|||||||.||||||||.|||||||.|
|.|||||||.||||||||.|||||||.|
|..........................|
|.||||||.||||||||||.||||||.|
|.||||||.||||||||||.||||||.|
|.||||||.||||||||||.||||||.|
|..........................|
|.||.|||.||||||||||.|||.||.|
|.||.|||.||||||||||.|||.||.|
|.||....................||.|
|.||.|||||.||||||.|||||.||.|
|.||.|||||.||||||.|||||.||.|
|.||.|||||.||||||.|||||.||.|
|.||.|||||.||||||.|||||.||.|
|..........................|
||||||||||||||||||||||||||||
