
||||||||||||||||||||||||||||
|..........................|
|.|||.||||.||..||.||||.|||.|
|.|||.||||.||..||.||||.|||.|
|.|||.||||.||..||.||||.|||.|
|.|||.||||.||..||.||||.|||.|
|..........||..||..........|
|.|||||.||.||..||.||.|||||.|
|.|||||.||.||..||.||.|||||.|
|.|||...||.||..||.||...|||.|
|.....||||.||..||.||||.....|
|.|||||||..........|||||||.|
|.|||||||.||||||||.|||||||.|
|.........||||||||.........|
|.|||.|||.||||||||.|||.|||.|
|.|||.|||.||||||||.|||.|||.|
|.|||.|||.||||||||.|||.|||.|
|.....|||..........|||.....|
|.|||.....||||||||.....|||.|
|.|||.|||.||||||||.|||.|||.|
|.||..|||..........|||..||.|
|.||.||||.||||||||.||||.||.|
|.||.||||.||||||||.||||.||.|
|.||.||||.||....||.||||.||.|
|......||.||.||.||.||......|
|.||||.||.||.||.||.||.||||.|
|.||||....||.||.||....||||.|
|.|||||||.||.||.||.|||||||.|
|.|||||||.||.||.||.|||||||.|
|..........................|
||||||||||||||||||||||||||||
