
||||||||||||||||||||||||||||
|..........................|
|.||||.||||.||||.||||.||||.|
|.||||.||||.||||.||||.||||.|
|.||||.||||.||||.||||.||||.|
|.||||.||||.||||.||||.||||.|
|.||...||||.||||.||||...||.|
|.||....................||.|
|.||.|||||.||||||.|||||.||.|
|....|||||.||||||.|||||....|
|.||....||.||||||.||....||.|
|.||||.||..........||.||||.|
|.||||.||.||||||||.||.||||.|
|.........||||||||.........|
|.|||.|||.||||||||.|||.|||.|
|.|||.|||.||||||||.|||.|||.|
|.|||.|||.||||||||.|||.|||.|
|.|||.|||..........|||.|||.|
|.........||.||.||.........|
|.|||.||||||.||.||||||.|||.|
|.|||.||||||.||.||||||.|||.|
|.|||.||..||....||..||.|||.|
|......||.||.||.||.||......|
|.||||.||.||.||.||.||.||||.|
|.||||.......||.......||||.|
|.||||.|||||.||.|||||.||||.|
|.||||.|||||.||.|||||.||||.|
|.||||.|||||.||.|||||.||||.|
|.||||.|||||.||.|||||.||||.|
|..........................|
||||||||||||||||||||||||||||
