
||||||||||||||||||||||||||||
|..........................|
|.|||.||||.||||||.||||.|||.|
|.|||.||||.||||||.||||.|||.|
|.|||.||||.||||||.||||.|||.|
|.|||......||||||......|||.|
|.|||.||||.||||||.||||.|||.|
|.....||||........||||.....|
|.|||.||||.||||||.||||.|||.|
|.|||.||||.||||||.||||.|||.|
|.|||.||||.||||||.||||.|||.|
|.|||..................|||.|
|.....|||.||||||||.|||.....|
|.|||.|||.||||||||.|||.|||.|
|.|||.|||.||||||||.|||.|||.|
|.|||.|||.||||||||.|||.|||.|
|.|||.....||||||||.....|||.|
|.|||.|||..........|||.|||.|
|.||..|||.||.||.||.|||..||.|
|....||||.||.||.||.||||....|
|.||.||||.||....||.||||.||.|
|.||.||||.||||||||.||||.||.|
|.||......||||||||......||.|
|.||.||||..........||||.||.|
|.||.||||.||||||||.||||.||.|
|....||...||||||||...||....|
|.|||||.||||||||||||.|||||.|
|.|||||.||||||||||||.|||||.|
|.|||||.||||||||||||.|||||.|
|..........................|
||||||||||||||||||||||||||||
