
||||||||||||||||||||||||||||
|..........................|
|.||||||.||.||||.||.||||||.|
|.||||||.||.||||.||.||||||.|
|.||.....||.||||.||.....||.|
|.||..||.||.||||.||.||..||.|
|.||||||.||.||||.||.||||||.|
|.||||...||.||||.||...||||.|
|.||||.||||.||||.||||.||||.|
|.||||.||||.||||.||||.||||.|
|.......|||.||||.|||.......|
|.||.||..............||.||.|
|.||.||||.||||||||.||||.||.|
|.||.||||.||||||||.||||.||.|
|.||.||||.||||||||.||||.||.|
|.||.||||.||||||||.||||.||.|
|.||.||||.||||||||.||||.||.|
|..........................|
|.||||.||.||||||||.||.||||.|
|.||||.||.||||||||.||.||||.|
|.||||.||.|||..|||.||.||||.|
|.||||.||..........||.||||.|
|......||.||||||||.||......|
|.||||.||.||||||||.||.||||.|
|.||||................||||.|
|....||||||.||||.||||||....|
|.||.||||||.||||.||||||.||.|
|.||.||||||.||||.||||||.||.|
|.||.||||||.||||.||||||.||.|
|..........................|
||||||||||||||||||||||||||||
