
||||||||||||||||||||||||||||
|..........................|
|.||.|||||.||||||.|||||.||.|
|.||.|||||.||||||.|||||.||.|
|.||..||||.||||||.||||..||.|
|.|||.||............||.|||.|
|.|||.||.||||||||||.||.|||.|
|.|||....||||||||||....|||.|
|.....||............||.....|
|.|||.|||.||||||||.|||.|||.|
|.|||.|||.||||||||.|||.|||.|
|.|||.|||..........|||.|||.|
|.|||.|||.||||||||.|||.|||.|
|.........||||||||.........|
|.|||||||.||||||||.|||||||.|
|.|||||||.||||||||.|||||||.|
|.||||....||||||||....||||.|
|.||||.||..........||.||||.|
|.||||.||.||||||||.||.||||.|
|......||.||||||||.||......|
|.||||.||.||||||||.||.||||.|
|.||||....||||||||....||||.|
|......||....||....||......|
|.||||.||.||.||.||.||.||||.|
|.||||.||.||.||.||.||.||||.|
|.||||.||.||....||.||.||||.|
|.||||.||.||||||||.||.||||.|
|.||||.||.||||||||.||.||||.|
|.||||.||.||||||||.||.||||.|
|..........................|
||||||||||||||||||||||||||||
