
||||||||||||||||||||||||||||
|..........................|
|.|||.||||||.||.||||||.|||.|
|.|||.||||||.||.||||||.|||.|
|.|||.||||||.||.||||||.|||.|
|.....||||||.||.||||||.....|
|.|||.||||........||||.|||.|
|.|||......||||||......|||.|
|.|||.||||.||||||.||||.|||.|
|.|||.||||.||||||.||||.|||.|
|.|||.||||.||||||.||||.|||.|
|.|||..................|||.|
|.....|||.||||||||.|||.....|
|.|||.|||.||||||||.|||.|||.|
|.|||.|||.||||||||.|||.|||.|
|.|||.....||||||||.....|||.|
|.|||||||.||||||||.|||||||.|
|.|||||||..........|||||||.|
|.........||.||.||.........|
|.||.||.||||.||.||||.||.||.|
|.||.||.||||.||.||||.||.||.|
|....||.||||.||.||||.||....|
|.||.||.||||.||.||||.||.||.|
|.||.||......||......||.||.|
|.||.||.||||.||.||||.||.||.|
|.||....||||....||||....||.|
|.||.||..||||||||||..||.||.|
|.||.|||.||||||||||.|||.||.|
|.||.|||.||||||||||.|||.||.|
|..........................|
||||||||||||||||||||||||||||
