
||||||||||||||||||||||||||||
|..........................|
|.|||||.|||.||||.|||.|||||.|
|.|||||.|||.||||.|||.|||||.|
|.|||||.|||......|||.|||||.|
|.......|||.||||.|||.......|
|.||.||.|||.||||.|||.||.||.|
|.||.||.||..||||..||.||.||.|
|.||.||....||||||....||.||.|
|....||.||.||||||.||.||....|
|.||||||||.||||||.||||||||.|
|.|||||||..........|||||||.|
|.........||||||||.........|
|.|||.|||.||||||||.|||.|||.|
|.|||.|||.||||||||.|||.|||.|
|.|||.|||.||||||||.|||.|||.|
|.|||.|||.||||||||.|||.|||.|
|.|||..................|||.|
|.......||||||||||||.......|
|.||.||.||||||||||||.||.||.|
|.||.||..............||.||.|
|.||.||.|||.||||.|||.||.||.|
|.||.||.|||.||||.|||.||.||.|
|.||.||.|||.||||.|||.||.||.|
|.||.||.|||......|||.||.||.|
|........||.||||.||........|
|.||||||....||||....||||||.|
|.||||||.||.||||.||.||||||.|
|.||||||.||.||||.||.||||||.|
|..........................|
||||||||||||||||||||||||||||
