
||||||||||||||||||||||||||||
|..........................|
|.|||.||.||.||||.||.||.|||.|
|.|||.||.||.||||.||.||.|||.|
|.|||.||.||......||.||.|||.|
|.|||.||.||.||||.||.||.|||.|
|.|||.||.||.||||.||.||.|||.|
|.|||.||.||.||||.||.||.|||.|
|.|||.||.||..||..||.||.|||.|
|.........||.||.||.........|
|.|||||||.||.||.||.|||||||.|
|.|||||||..........|||||||.|
|.|||||||.||||||||.|||||||.|
|.|||||||.||||||||.|||||||.|
|....||||.||||||||.||||....|
|.||......||||||||......||.|
|.||||||..||||||||..||||||.|
|.||||||............||||||.|
|.||||||.||||||||||.||||||.|
|.||||||.||||||||||.||||||.|
|..........................|
|.|||.||.||.||||.||.||.|||.|
|.|||.||.||.||||.||.||.|||.|
|.....||.||.||||.||.||.....|
|.||||||.||.||||.||.||||||.|
|.||||||.||.||||.||.||||||.|
|.....||....||||....||.....|
|.|||.||.||||||||||.||.|||.|
|.|||.||.||||||||||.||.|||.|
|..........................|
||||||||||||||||||||||||||||
