
||||||||||||||||||||||||||||
|..........................|
|.||.||||||.||||.||||||.||.|
|.||.||||||.||||.||||||.||.|
|.||........||||........||.|
|.|||||.||||||||||||.|||||.|
|.|||||.||||||||||||.|||||.|
|.|||||.||||||||||||.|||||.|
|..........................|
|.||.||||||||||||||||||.||.|
|.||.||||||||||||||||||.||.|
|..........................|
|.|||||||.||||||||.|||||||.|
|.|||||||.||||||||.|||||||.|
|.........||||||||.........|
|.|||||||.||||||||.|||||||.|
|.|||||||.||||||||.|||||||.|
|..........................|
|.||||||.|||.||.|||.||||||.|
|.||||||.|||.||.|||.||||||.|
|.|||....|||.||.|||....|||.|
|.|||.||||||.||.||||||.|||.|
|.....||||||.||.||||||.....|
|.|||........||........|||.|
|.|||.||||||.||.||||||.|||.|
|.|||.||||||.||.||||||.|||.|
|.|||........||........|||.|
|.|||.||||||.||.||||||.|||.|
|.|||.||||||.||.||||||.|||.|
|..........................|
||||||||||||||||||||||||||||
