
||||||||||||||||||||||||||||
|..........................|
|.|||||||.||||||||.|||||||.|
|.|||||||.||||||||.|||||||.|
|.|||||||.||||||||.|||||||.|
|..........................|
|.||||.||||.||||.||||.||||.|
|.||||.||||.||||.||||.||||.|
|.||||.||||..||..||||.||||.|
|.||||.|||||.||.|||||.||||.|
|.........||.||.||.........|
|.|||||||..........|||||||.|
|.|||||||.||||||||.|||||||.|
|.........||||||||.........|
|.|||.|||.||||||||.|||.|||.|
|.|||.|||.||||||||.|||.|||.|
|.|||.|||.||||||||.|||.|||.|
|.|||.|||..........|||.|||.|
|.|||.|||.||||||||.|||.|||.|
|.|||.||..||||||||..||.|||.|
|.....||.||||||||||.||.....|
|.|||.||.||......||.||.|||.|
|.|||.......||||.......|||.|
|.....||.||||||||||.||.....|
|.|||.||.||||||||||.||.|||.|
|.|||.||.||......||.||.|||.|
|.|||.||.||.||||.||.||.|||.|
|.|||.||.||.||||.||.||.|||.|
|.|||.||.||.||||.||.||.|||.|
|..........................|
||||||||||||||||||||||||||||
