
||||||||||||||||||||||||||||
|..........................|
|.||||||.||||||||||.||||||.|
|.||||||.||||||||||.||||||.|
|.||||||.....||.....||||||.|
|.||||||.|||.||.|||.||||||.|
|.||||||.|||.||.|||.||||||.|
|.||||||.|||.||.|||.||||||.|
|........|||....|||........|
|.||||||.|||.||.|||.||||||.|
|.||||||.|||.||.|||.||||||.|
|..........................|
|.|||.|||.||||||||.|||.|||.|
|.|||.|||.||||||||.|||.|||.|
|.|||.|||.||||||||.|||.|||.|
|.|||.|||.||||||||.|||.|||.|
|.|||.....||||||||.....|||.|
|.|||.||............||.|||.|
|.|||.||.||||||||||.||.|||.|
|........||||||||||........|
|.||||||............||||||.|
|.||||||.||||||||||.||||||.|
|.||.....||||||||||.....||.|
|.||.||.|||||..|||||.||.||.|
|.||.||.||........||.||.||.|
|.||.||....||..||....||.||.|
|....|||.||||..||||.|||....|
|.||.|||.||||..||||.|||.||.|
|.||.|||.||||..||||.|||.||.|
|..........................|
||||||||||||||||||||||||||||
