
||||||||||||||||||||||||||||
|..........................|
|.|||||.||.||||||.||.|||||.|
|.|||||.||.||||||.||.|||||.|
|.|||||.||...||...||.|||||.|
|.......||||.||.||||.......|
|.|||||.||||.||.||||.|||||.|
|.|||||......||......|||||.|
|....||.||||....||||.||....|
|.||.||.||||||||||||.||.||.|
|.||.||...||||||||...||.||.|
|.||.||||..........||||.||.|
|.||.||||.||||||||.||||.||.|
|.||......||||||||......||.|
|.|||.|||.||||||||.|||.|||.|
|.|||.|||.||||||||.|||.|||.|
|.|||.|||.||||||||.|||.|||.|
|.....||............||.....|
|.||||||.||||||||||.||||||.|
|.||||||.||||||||||.||||||.|
|........||......||........|
|.||||||.||.||||.||.||||||.|
|.||||||.||.||||.||.||||||.|
|....|||.||.||||.||.|||....|
|.||.|||....||||....|||.||.|
|.||.|||.||......||.|||.||.|
|.||.....||||||||||.....||.|
|.||.|||.||||||||||.|||.||.|
|.||.|||.||||||||||.|||.||.|
|..........................|
||||||||||||||||||||||||||||
