
||||||||||||||||||||||||||||
|..........................|
|.||||||.||||..||||.||||||.|
|.||||||.||||..||||.||||||.|
|.||||||.||||..||||.||||||.|
|.|||....||||||||||....|||.|
|.....||....||||....||.....|
|.||||||.||......||.||||||.|
|.||||||.||||..||||.||||||.|
|.....||..|||..|||..||.....|
|.|||.|||.|||..|||.|||.|||.|
|.|||.|||..........|||.|||.|
|.|||.....||||||||.....|||.|
|.|||.|||.||||||||.|||.|||.|
|.....|||.||||||||.|||.....|
|.|||||||.||||||||.|||||||.|
|.|||||||.||||||||.|||||||.|
|..........................|
|.||||||.||||||||||.||||||.|
|.||||||.||||||||||.||||||.|
|........||||||||||........|
|.||||||.||||||||||.||||||.|
|.||||||....||||....||||||.|
|.||||||.||.||||.||.||||||.|
|.||||||.||.||||.||.||||||.|
|..........................|
|.||||||.||||||||||.||||||.|
|.||||||.||||||||||.||||||.|
|.||||||.||||||||||.||||||.|
|..........................|
||||||||||||||||||||||||||||
