
||||||||||||||||||||||||||||
|..........................|
|.||||.||||||||||||||.||||.|
|.||||.||||||||||||||.||||.|
|......||||||||||||||......|
|.||||.||||||||||||||.||||.|
|.||||................||||.|
|.||||.|||.||||||.|||.||||.|
|.||||.|||.||||||.|||.||||.|
|......|||.||||||.|||......|
|.||.|||||.||||||.|||||.||.|
|.||.||||..........||||.||.|
|.||......||||||||......||.|
|.||.||||.||||||||.||||.||.|
|.||.||||.||||||||.||||.||.|
|.||.||||.||||||||.||||.||.|
|.||.||||.||||||||.||||.||.|
|....||..............||....|
|.||.||.|||||..|||||.||.||.|
|.||....|||||..|||||....||.|
|.||.||.|||||..|||||.||.||.|
|.||.||.|||||..|||||.||.||.|
|.||.||.|||||..|||||.||.||.|
|.||.||..............||.||.|
|.||.||||||.||||.||||||.||.|
|.||.||||||.||||.||||||.||.|
|...........||||...........|
|.|||||||.||||||||.|||||||.|
|.|||||||.||||||||.|||||||.|
|..........................|
||||||||||||||||||||||||||||
