
||||||||||||||||||||||||||||
|..........................|
|.||||||.||.||||.||.||||||.|
|.||||||.||.||||.||.||||||.|
|...........||||...........|
|.||.||||||.||||.||||||.||.|
|.||.||||||.||||.||||||.||.|
|..........................|
|.|||||.||||.||.||||.|||||.|
|.|||||.||||.||.||||.|||||.|
|.|||||.||||.||.||||.|||||.|
|.|||||..............|||||.|
|.....|||.||||||||.|||.....|
|.|||.|||.||||||||.|||.|||.|
|.|||.....||||||||.....|||.|
|.|||||||.||||||||.|||||||.|
|.|||||||.||||||||.|||||||.|
|..........................|
|.|||.||||||.||.||||||.|||.|
|.|||.||||||.||.||||||.|||.|
|.||....................||.|
|....||.||||||||||||.||....|
|.||.||.||||||||||||.||.||.|
|.||.||..............||.||.|
|.||.||.||||||||||||.||.||.|
|.||.||.||||||||||||.||.||.|
|.||.||..............||.||.|
|.||.||.||||||||||||.||.||.|
|.||.||.||||||||||||.||.||.|
|..........................|
||||||||||||||||||||||||||||
