
||||||||||||||||||||||||||||
|..........................|
|.||||||.||.||||.||.||||||.|
|.||||||.||.||||.||.||||||.|
|.||||||.||......||.||||||.|
|.....||.||.||||.||.||.....|
|.|||.||.||.||||.||.||.|||.|
|.|||.||.||.||||.||.||.|||.|
|.||.....||.||||.||.....||.|
|.||.|||.||.||||.||.|||.||.|
|....|||.||.||||.||.|||....|
|.||.|||............|||.||.|
|.||.||||.||||||||.||||.||.|
|.||.||||.||||||||.||||.||.|
|.||.||||.||||||||.||||.||.|
|.||.||||.||||||||.||||.||.|
|.||......||||||||......||.|
|....||||..........||||....|
|.||.||||.||||||||.||||.||.|
|.||..||..||||||||..||..||.|
|.|||.||.||||||||||.||.|||.|
|.|||.||.||......||.||.|||.|
|.||.....||.||||.||.....||.|
|....|||.||.||||.||.|||....|
|.||.|||.....||.....|||.||.|
|.||..||.|||.||.|||.||..||.|
|.|||.||.|||....|||.||.|||.|
|.|||.||.||||||||||.||.|||.|
|.|||.||.||||||||||.||.|||.|
|..........................|
||||||||||||||||||||||||||||
