
||||||||||||||||||||||||||||
|..........................|
|.|||||||.||.||.||.|||||||.|
|.|||||||.||.||.||.|||||||.|
|.........||....||.........|
|.|||||||.||||||||.|||||||.|
|.|||||||.||||||||.|||||||.|
|.|||||||.||....||.|||||||.|
|.|||||||.||.||.||.|||||||.|
|.|||||||.||.||.||.|||||||.|
|.||||....||.||.||....||||.|
|......||..........||......|
|.||.||||.||||||||.||||.||.|
|.||.||||.||||||||.||||.||.|
|.||.||||.||||||||.||||.||.|
|.||.||||.||||||||.||||.||.|
|.||.||||.||||||||.||||.||.|
|.||.||||..........||||.||.|
|......||.||||||||.||......|
|.||||....||||||||....||||.|
|.|||||||.||||||||.|||||||.|
|.|||||||.||||||||.|||||||.|
|..........................|
|.|||||||.|||..|||.|||||||.|
|.|||||||.|||..|||.|||||||.|
|......||..||..||..||......|
|.||||.|||.||..||.|||.||||.|
|.||||.|||.||..||.|||.||||.|
|.||||.|||.||..||.|||.||||.|
|..........................|
||||||||||||||||||||||||||||
