
||||||||||||||||||||||||||||
|..........................|
|.|||.||||.||||||.||||.|||.|
|.|||.||||.||||||.||||.|||.|
|.|||.||||.||||||.||||.|||.|
|..........................|
|.||||.||||||..||||||.||||.|
|.||||.||||||..||||||.||||.|
|.||||................||||.|
|.||||.||||||||||||||.||||.|
|.||||.||||||||||||||.||||.|
|..........................|
|.|||||||.||||||||.|||||||.|
|.|||||||.||||||||.|||||||.|
|.||......||||||||......||.|
|.||.||||.||||||||.||||.||.|
|.||.||||.||||||||.||||.||.|
|.||.||||..........||||.||.|
|....||||.||||||||.||||....|
|.||.||||.||||||||.||||.||.|
|.||...||.||||||||.||...||.|
|.|||..||..........||..|||.|
|.|||..||.||||||||.||..|||.|
|.|||.|||.||||||||.|||.|||.|
|.|||.||............||.|||.|
|.|||....||||..||||....|||.|
|.....||.||||..||||.||.....|
|.||||||.||||..||||.||||||.|
|.||||||.||||..||||.||||||.|
|..........................|
||||||||||||||||||||||||||||
