
||||||||||||||||||||||||||||
|..........................|
|.|||.|||.||.||.||.|||.|||.|
|.|||.|||.||.||.||.|||.|||.|
|.|||.....||....||.....|||.|
|.|||.||||||||||||||||.|||.|
|.|||.||||||||||||||||.|||.|
|..........................|
|.|||.|||.||||||||.|||.|||.|
|.|||.|||.||||||||.|||.|||.|
|.|||.|||.||||||||.|||.|||.|
|.|||.|||..........|||.|||.|
|.........||||||||.........|
|.||.||||.||||||||.||||.||.|
|.||.||||.||||||||.||||.||.|
|.||.||||.||||||||.||||.||.|
|.||.||||.||||||||.||||.||.|
|.||....................||.|
|.||.||||.||.||.||.||||.||.|
|.||.||||.||.||.||.||||.||.|
|.||.||||.||.||.||.||||.||.|
|.........||.||.||.........|
|.|||||||.||.||.||.|||||||.|
|.|||||||.||.||.||.|||||||.|
|......||.||.||.||.||......|
|.||||.||..........||.||||.|
|.||||.||.||||||||.||.||||.|
|.||||.||.||||||||.||.||||.|
|.||||.||.||||||||.||.||||.|
|..........................|
||||||||||||||||||||||||||||
