
||||||||||||||||||||||||||||
|..........................|
|.|||||||.||.||.||.|||||||.|
|.|||||||.||.||.||.|||||||.|
|....||||.||.||.||.||||....|
|.||.||||.||....||.||||.||.|
|.||.||||.|||..|||.||||.||.|
|.||.||||.|||..|||.||||.||.|
|.||....................||.|
|.||.||||||||||||||||||.||.|
|.||.||||||||||||||||||.||.|
|.||....................||.|
|.||.||||.||||||||.||||.||.|
|.||.||||.||||||||.||||.||.|
|......||.||||||||.||......|
|.||||.||.||||||||.||.||||.|
|.||||....||||||||....||||.|
|.||||.||..........||.||||.|
|.||||.||||.||||.||||.||||.|
|........||.||||.||........|
|.||||||.||.||||.||.||||||.|
|.||||||.||.||||.||.||||||.|
|....|||.||.||||.||.|||....|
|.||.|||.||.||||.||.|||.||.|
|.||....................||.|
|.||||.||||||..||||||.||||.|
|.||||.||||||..||||||.||||.|
|.||||.||||||..||||||.||||.|
|.||||.||||||..||||||.||||.|
|..........................|
||||||||||||||||||||||||||||
