
||||||||||||||||||||||||||||
|..........................|
|.|||||||.||||||||.|||||||.|
|.|||||||.||||||||.|||||||.|
|.........||||||||.........|
|.|||||||.||||||||.|||||||.|
|.|||||||..........|||||||.|
|.........|||..|||.........|
|.|||||||.|||..|||.|||||||.|
|.|||||||.|||..|||.|||||||.|
|.........|||..|||.........|
|.|||||||..........|||||||.|
|.|||||||.||||||||.|||||||.|
|.||......||||||||......||.|
|.||.||||.||||||||.||||.||.|
|....||||.||||||||.||||....|
|.||.||||.||||||||.||||.||.|
|.||.||||..........||||.||.|
|.||.......||||||.......||.|
|.||.||.||.||||||.||.||.||.|
|.||.||.||.||||||.||.||.||.|
|.||.||.||.||||||.||.||.||.|
|....||.||........||.||....|
|.||.||.||.||..||.||.||.||.|
|.||.||.||.||..||.||.||.||.|
|.||....||.||..||.||....||.|
|.||.||....||||||....||.||.|
|.||.|||||.||||||.|||||.||.|
|.||.|||||.||||||.|||||.||.|
|..........................|
||||||||||||||||||||||||||||
