
||||||||||||||||||||||||||||
|..........................|
|.|||.||.||||||||||.||.|||.|
|.|||.||.||||||||||.||.|||.|
|.|||.||...||||||...||.|||.|
|.|||.||||........||||.|||.|
|.|||.||||.||||||.||||.|||.|
|..........||||||..........|
|.||||.||.||||||||.||.||||.|
|.||||.||.||||||||.||.||||.|
|.||||.||.||||||||.||.||||.|
|......||..........||......|
|.|||||||.||||||||.|||||||.|
|.|||||||.||||||||.|||||||.|
|......||.||||||||.||......|
|.||||.||.||||||||.||.||||.|
|.||||.||.||||||||.||.||||.|
|..........................|
|.||||||.||||..||||.||||||.|
|.||||||.||||..||||.||||||.|
|.||||||.||||..||||.||||||.|
|.||||||............||||||.|
|........||.||||.||........|
|.|||||.|||.||||.|||.|||||.|
|.|||||.||........||.|||||.|
|.|||||.|||.||||.|||.|||||.|
|.......|||.||||.|||.......|
|.|||||.|||.||||.|||.|||||.|
|.|||||.|||.||||.|||.|||||.|
|..........................|
||||||||||||||||||||||||||||
