
||||||||||||||||||||||||||||
|..........................|
|.||||||.||.||||.||.||||||.|
|.||||||.||.||||.||.||||||.|
|.||||||.||.||||.||.||||||.|
|.|||||..||.||||.||..|||||.|
|.......|||......|||.......|
|.|||.||||..||||..||||.|||.|
|.|||.||...||||||...||.|||.|
|.|||.||.||||||||||.||.|||.|
|.|||.||.||||||||||.||.|||.|
|..........................|
|.||.||||.||||||||.||||.||.|
|.||.||||.||||||||.||||.||.|
|.||.||||.||||||||.||||.||.|
|....||||.||||||||.||||....|
|.||......||||||||......||.|
|.||.||||..........||||.||.|
|.||.||||.||.||.||.||||.||.|
|.||.||||.||.||.||.||||.||.|
|.||.||...||.||.||...||.||.|
|.||.||.||||.||.||||.||.||.|
|.......||||.||.||||.......|
|.||.||..............||.||.|
|.||.||.|||.||||.|||.||.||.|
|....||.|||.||||.|||.||....|
|.|||||.|||.||||.|||.|||||.|
|.|||||.|||.||||.|||.|||||.|
|.|||||.|||.||||.|||.|||||.|
|..........................|
||||||||||||||||||||||||||||
