
||||||||||||||||||||||||||||
|..........................|
|.||||.||||.||||.||||.||||.|
|.||||.||||.||||.||||.||||.|
|.||||.||||......||||.||||.|
|.||||......||||......||||.|
|.||||.||||.||||.||||.||||.|
|.||||.||||.||||.||||.||||.|
|.||||.||...||||...||.||||.|
|.||||.||.||||||||.||.||||.|
|.........||||||||.........|
|.||.||||..........||||.||.|
|.||.||||.||||||||.||||.||.|
|.||.||||.||||||||.||||.||.|
|.||.||||.||||||||.||||.||.|
|.||.||||.||||||||.||||.||.|
|.||.||||.||||||||.||||.||.|
|.||.||||..........||||.||.|
|.||......|||..|||......||.|
|.||.|||.||||..||||.|||.||.|
|.||.|||.||||..||||.|||.||.|
|.||.||..............||.||.|
|.......||.||..||.||.......|
|.||||||||.||..||.||||||||.|
|.||||||...||..||...||||||.|
|.|||....||||..||||....|||.|
|.|||.||.||||..||||.||.|||.|
|.|||.||.||||..||||.||.|||.|
|.|||.||.||||..||||.||.|||.|
|..........................|
||||||||||||||||||||||||||||
