
||||||||||||||||||||||||||||
|..........................|
|.||||.||||.||||.||||.||||.|
|.||||.||||.||||.||||.||||.|
|.||||.|||..||||..|||.||||.|
|.||||.|||.||||||.|||.||||.|
|..........||||||..........|
|.||.|||||.||||||.|||||.||.|
|.||.|||||........|||||.||.|
|.......||.||||||.||.......|
|.||||..||.||||||.||..||||.|
|.||||................||||.|
|.||||.||.||||||||.||.||||.|
|.||||.||.||||||||.||.||||.|
|.||||.||.||||||||.||.||||.|
|......||.||||||||.||......|
|.||||.||.||||||||.||.||||.|
|.||||.||..........||.||||.|
|.||||.||||.||||.||||.||||.|
|.||||.||||.||||.||||.||||.|
|.||||.||||......||||.||||.|
|...........||||...........|
|.||||.||||.||||.||||.||||.|
|.||||.||||.||||.||||.||||.|
|.||||.||||.||||.||||.||||.|
|.||||.||||.||||.||||.||||.|
|......||||.||||.||||......|
|.||||.||||.||||.||||.||||.|
|.||||.||||.||||.||||.||||.|
|..........................|
||||||||||||||||||||||||||||
