
||||||||||||||||||||||||||||
|..........................|
|.|||||||.||||||||.|||||||.|
|.|||||||.||||||||.|||||||.|
|.|||||||..........|||||||.|
|.........||.||.||.........|
|.||||.||.||.||.||.||.||||.|
|.||||.||.||.||.||.||.||||.|
|.||||.||.||.||.||.||.||||.|
|.||||.||.||.||.||.||.||||.|
|......||.||.||.||.||......|
|.||.||||..........||||.||.|
|.||.||||.||||||||.||||.||.|
|.||.||||.||||||||.||||.||.|
|.||.||||.||||||||.||||.||.|
|.||......||||||||......||.|
|.||.||||.||||||||.||||.||.|
|.||.||||..........||||.||.|
|.||.||||.||||||||.||||.||.|
|....||||.||||||||.||||....|
|.||....................||.|
|.||||||.||||||||||.||||||.|
|.||||||.||||||||||.||||||.|
|.|||..................|||.|
|.....||.||.||||.||.||.....|
|.||||||.||.||||.||.||||||.|
|.||||...||......||...||||.|
|.||||.||||||||||||||.||||.|
|.||||.||||||||||||||.||||.|
|..........................|
||||||||||||||||||||||||||||
