
||||||||||||||||||||||||||||
|..........................|
|.|||||.||.||..||.||.|||||.|
|.|||||.||.||..||.||.|||||.|
|.|||||.||.||..||.||.|||||.|
|.|||......||..||......|||.|
|.....||||||||||||||||.....|
|.|||.||||||||||||||||.|||.|
|.|||..................|||.|
|.|||.||||||.||.||||||.|||.|
|.|||.||||||.||.||||||.|||.|
|..........................|
|.|||||||.||||||||.|||||||.|
|.|||||||.||||||||.|||||||.|
|.|||||||.||||||||.|||||||.|
|.........||||||||.........|
|.|||.|||.||||||||.|||.|||.|
|.|||.|||..........|||.|||.|
|.|||.|||.||||||||.|||.|||.|
|.|||.||..||||||||..||.|||.|
|.........||....||.........|
|.|||||||.||.||.||.|||||||.|
|.|||||||.||.||.||.|||||||.|
|.........||.||.||.........|
|.|||||||.||.||.||.|||||||.|
|.|||||||..........|||||||.|
|.||||....||||||||....||||.|
|.||||.||.||||||||.||.||||.|
|.||||.||.||||||||.||.||||.|
|..........................|
||||||||||||||||||||||||||||
