
||||||||||||||||||||||||||||
|..........................|
|.|||||||||.||||.|||||||||.|
|.|||||||||.||||.|||||||||.|
|.|||||||||.||||.|||||||||.|
|...........||||...........|
|.||.||||||.||||.||||||.||.|
|.||.||||||.||||.||||||.||.|
|....|||....||||....|||....|
|.||.....||.||||.||.....||.|
|.||.||||||.||||.||||||.||.|
|.||.||||..........||||.||.|
|.||.||||.||||||||.||||.||.|
|.||.||||.||||||||.||||.||.|
|.||......||||||||......||.|
|....||||.||||||||.||||....|
|.|||||||.||||||||.|||||||.|
|.||||||............||||||.|
|.||||||.||||||||||.||||||.|
|........||||||||||........|
|.||||||.||||||||||.||||||.|
|.||||||.||||||||||.||||||.|
|.||||||............||||||.|
|.||||||.||||||||||.||||||.|
|.||.....||||||||||.....||.|
|.||.||..||||||||||..||.||.|
|....||.....||||.....||....|
|.|||||||||.||||.|||||||||.|
|.|||||||||.||||.|||||||||.|
|..........................|
||||||||||||||||||||||||||||
