
||||||||||||||||||||||||||||
|..........................|
|.|||||.||||||||||||.|||||.|
|.|||||.||||||||||||.|||||.|
|.||....||||....||||....||.|
|.||.||......||......||.||.|
|....||.||||.||.||||.||....|
|.|||||.||||.||.||||.|||||.|
|.|||||.||||.||.||||.|||||.|
|.......||||.||.||||.......|
|.||.||.||||.||.||||.||.||.|
|.||.||..............||.||.|
|.||.||||.||||||||.||||.||.|
|.||.||||.||||||||.||||.||.|
|.||.||||.||||||||.||||.||.|
|....||||.||||||||.||||....|
|.|||||||.||||||||.|||||||.|
|.||||................||||.|
|......||||.||||.||||......|
|.||||.||||.||||.||||.||||.|
|.||||.||||.||||.||||.||||.|
|.||||.||||.||||.||||.||||.|
|.|||.......||||.......|||.|
|.....||.||||||||||.||.....|
|.||||||.||||||||||.||||||.|
|.||||||.||......||.||||||.|
|...........||||...........|
|.|||||||.||||||||.|||||||.|
|.|||||||.||||||||.|||||||.|
|..........................|
||||||||||||||||||||||||||||
