
||||||||||||||||||||||||||||
|..........................|
|.||.|||.||||..||||.|||.||.|
|.||.|||.||||..||||.|||.||.|
|.||.|||.||||..||||.|||.||.|
|.||....................||.|
|.||...||.|||..|||.||...||.|
|.|||||||.|||..|||.|||||||.|
|.|||||||.|||..|||.|||||||.|
|.||......|||..|||......||.|
|....||||.|||..|||.||||....|
|.|||||||..........|||||||.|
|.|||||||.||||||||.|||||||.|
|.|||||||.||||||||.|||||||.|
|.........||||||||.........|
|.|||||||.||||||||.|||||||.|
|.|||||||.||||||||.|||||||.|
|.|||||||..........|||||||.|
|.|||||||.||.||.||.|||||||.|
|.........||.||.||.........|
|.|||.||.||..||..||.||.|||.|
|.|||.||.||||||||||.||.|||.|
|.|||.||.||||||||||.||.|||.|
|.|||.||.....||.....||.|||.|
|.....||.|||.||.|||.||.....|
|.|||.||.|||.||.|||.||.|||.|
|.|||..................|||.|
|.|||.||.||||||||||.||.|||.|
|.|||.||.||||||||||.||.|||.|
|..........................|
||||||||||||||||||||||||||||
