
||||||||||||||||||||||||||||
|..........................|
|.||||.|||.||||||.|||.||||.|
|.||||.|||.||||||.|||.||||.|
|.||||.|||.||||||.|||.||||.|
|.||||.|||.||||||.|||.||||.|
|............||............|
|.||||||||||.||.||||||||||.|
|.||||||||||.||.||||||||||.|
|.........||.||.||.........|
|.||.||||.||.||.||.||||.||.|
|.||.||||..........||||.||.|
|.||.||||.||||||||.||||.||.|
|.||.||||.||||||||.||||.||.|
|.........||||||||.........|
|.|||||||.||||||||.|||||||.|
|.|||||||.||||||||.|||||||.|
|.||....................||.|
|.||.||||.||||||||.||||.||.|
|.||.||||.||||||||.||||.||.|
|.||.||||..........||||.||.|
|......||||||||||||||......|
|.||||...||||||||||...||||.|
|.||||||............||||||.|
|.||||||..||.||.||..||||||.|
|.........||.||.||.........|
|.|||||||....||....|||||||.|
|.|||||||.||||||||.|||||||.|
|.|||||||.||||||||.|||||||.|
|..........................|
||||||||||||||||||||||||||||
