
||||||||||||||||||||||||||||
|..........................|
|.||||||.||.||||.||.||||||.|
|.||||||.||.||||.||.||||||.|
|.||||||....||||....||||||.|
|.||||||.||.||||.||.||||||.|
|.|||....||......||....|||.|
|.....||.||.||||.||.||.....|
|.||||||.||.||||.||.||||||.|
|.||||||.||.||||.||.||||||.|
|........||.||||.||........|
|.||||................||||.|
|.||||.||.||||||||.||.||||.|
|.||||.||.||||||||.||.||||.|
|.||......||||||||......||.|
|.||.||||.||||||||.||||.||.|
|.||.||||.||||||||.||||.||.|
|....||||..........||||....|
|.||.||||.||.||.||.||||.||.|
|.||......||.||.||......||.|
|.||.|||||||.||.|||||||.||.|
|.||.||||||......||||||.||.|
|.||.||||||.||||.||||||.||.|
|.||........||||........||.|
|.||.||||||.||||.||||||.||.|
|.||.||||||.||||.||||||.||.|
|.||....................||.|
|.||||.||||||..||||||.||||.|
|.||||.||||||..||||||.||||.|
|..........................|
||||||||||||||||||||||||||||
