
||||||||||||||||||||||||||||
|..........................|
|.||||.|||.||..||.|||.||||.|
|.||||.|||.||..||.|||.||||.|
|.||||.|||.||..||.|||.||||.|
|.||||.|||.||||||.|||.||||.|
|.||||.|||.||||||.|||.||||.|
|.||||.|||........|||.||||.|
|..........||||||..........|
|.||||||.||||||||||.||||||.|
|.||||||.||||||||||.||||||.|
|.|||..................|||.|
|.|||.|||.||||||||.|||.|||.|
|.|||.|||.||||||||.|||.|||.|
|.........||||||||.........|
|.||.||||.||||||||.||||.||.|
|.||.||||.||||||||.||||.||.|
|.||.||||..........||||.||.|
|.||.||||.||.||.||.||||.||.|
|.||.||||.||.||.||.||||.||.|
|.||......||.||.||......||.|
|....|||||||.||.|||||||....|
|.||.|||||||.||.|||||||.||.|
|.||......||.||.||......||.|
|.|||||||.||.||.||.|||||||.|
|.|||||||.||.||.||.|||||||.|
|..........................|
|.|||||||||||..|||||||||||.|
|.|||||||||||..|||||||||||.|
|..........................|
||||||||||||||||||||||||||||
