
||||||||||||||||||||||||||||
|..........................|
|.|||.||.||||||||||.||.|||.|
|.|||.||.||||||||||.||.|||.|
|.|||....||||||||||....|||.|
|.||||||............||||||.|
|.||||||.||||||||||.||||||.|
|........||||||||||........|
|.|||.||....||||....||.|||.|
|.|||.|||||.||||.|||||.|||.|
|.|||..||||.||||.||||..|||.|
|.||||.||..........||.||||.|
|.||||.||.||||||||.||.||||.|
|.||||.||.||||||||.||.||||.|
|.||||.||.||||||||.||.||||.|
|.........||||||||.........|
|.|||||||.||||||||.|||||||.|
|.|||||||..........|||||||.|
|..........||||||..........|
|.||||.|||.||||||.|||.||||.|
|.||||.|||.||||||.|||.||||.|
|.||||.|||.||||||.|||.||||.|
|.||||.|||.||..||.|||.||||.|
|......|||.||..||.|||......|
|.|||......||..||......|||.|
|.|||.||||........||||.|||.|
|.|||.||||.||||||.||||.|||.|
|.|||.||||.||||||.||||.|||.|
|.|||.||||.||||||.||||.|||.|
|..........................|
||||||||||||||||||||||||||||
