
||||||||||||||||||||||||||||
|..........................|
|.||||||.||||..||||.||||||.|
|.||||||.||||..||||.||||||.|
|........||||..||||........|
|.||||||.||||..||||.||||||.|
|.||||||............||||||.|
|.||||||.|||.||.|||.||||||.|
|.||||||.|||.||.|||.||||||.|
|.||||||.|||.||.|||.||||||.|
|.|||.....||.||.||.....|||.|
|.|||.|||..........|||.|||.|
|.....|||.||||||||.|||.....|
|.||.||||.||||||||.||||.||.|
|.||.||||.||||||||.||||.||.|
|.||.||||.||||||||.||||.||.|
|.||.||||.||||||||.||||.||.|
|..........................|
|.|||||||.||.||.||.|||||||.|
|.|||||||.||.||.||.|||||||.|
|.........||.||.||.........|
|.|||||||.||.||.||.|||||||.|
|.|||||||.||.||.||.|||||||.|
|.|||||||.||.||.||.|||||||.|
|..........................|
|.||||.||.||||||||.||.||||.|
|.||||.||.||||||||.||.||||.|
|.||||.||.||||||||.||.||||.|
|.||||.||.||||||||.||.||||.|
|..........................|
||||||||||||||||||||||||||||
