
||||||||||||||||||||||||||||
|..........................|
|.||.||||||.||||.||||||.||.|
|.||.||||||.||||.||||||.||.|
|.||....................||.|
|.||.|||.||||..||||.|||.||.|
|.||.|||.||||||||||.|||.||.|
|.||.|||.||||||||||.|||.||.|
|.||........||||........||.|
|.||.||||||.||||.||||||.||.|
|.||.||||||.||||.||||||.||.|
|.||.||||..........||||.||.|
|.........||||||||.........|
|.||||.||.||||||||.||.||||.|
|.||||.||.||||||||.||.||||.|
|.||||....||||||||....||||.|
|.||||.||.||||||||.||.||||.|
|.||||.||..........||.||||.|
|......||||.||||.||||......|
|.||||.||||.||||.||||.||||.|
|.||||.||||.||||.||||.||||.|
|.||||.||||.||||.||||.||||.|
|...........||||...........|
|.||.||||.||||||||.||||.||.|
|.||.||||.||....||.||||.||.|
|.||.||||....||....||||.||.|
|.||.||||.||||||||.||||.||.|
|.||.||||.||||||||.||||.||.|
|.||.||||.||||||||.||||.||.|
|..........................|
||||||||||||||||||||||||||||
