
||||||||||||||||||||||||||||
|..........................|
|.|||||||.||||||||.|||||||.|
|.|||||||.||||||||.|||||||.|
|..........||||||..........|
|.||||.|||.||||||.|||.||||.|
|.||||.|||........|||.||||.|
|.||||.|||.||||||.|||.||||.|
|.||||.|||.||||||.|||.||||.|
|.||||..||.||||||.||..||||.|
|.......||.||||||.||.......|
|.||.||..............||.||.|
|.||.||||.||||||||.||||.||.|
|.||.||||.||||||||.||||.||.|
|.||......||||||||......||.|
|.|||||||.||||||||.|||||||.|
|.|||||||.||||||||.|||||||.|
|..........................|
|.|||||||.||||||||.|||||||.|
|.|||||||.||||||||.|||||||.|
|..........................|
|.||||||.||||||||||.||||||.|
|.||||||.||||||||||.||||||.|
|.||||||............||||||.|
|........||||||||||........|
|.|||||..||||||||||..|||||.|
|.|||||..............|||||.|
|.|||||.||||||||||||.|||||.|
|.|||||.||||||||||||.|||||.|
|..........................|
||||||||||||||||||||||||||||
