
||||||||||||||||||||||||||||
|..........................|
|.||||.||||||..||||||.||||.|
|.||||.||||||..||||||.||||.|
|.|||..................|||.|
|.....||.||||||||||.||.....|
|.|||.||.||||||||||.||.|||.|
|.|||.||.||||||||||.||.|||.|
|.|||.||..||||||||..||.|||.|
|.|||.|||.||||||||.|||.|||.|
|.|||.|||.||||||||.|||.|||.|
|..........................|
|.|||||||.||||||||.|||||||.|
|.|||||||.||||||||.|||||||.|
|.|||.....||||||||.....|||.|
|.|||..||.||||||||.||..|||.|
|.|||||||.||||||||.|||||||.|
|.|||||..............|||||.|
|.||....||||.||.||||....||.|
|....||.||||.||.||||.||....|
|.|||||.||||.||.||||.|||||.|
|.|||..................|||.|
|.||..|||.||||||||.|||..||.|
|.||.||||.||||||||.||||.||.|
|.||.||||.||||||||.||||.||.|
|.||......||||||||......||.|
|.||.||||..........||||.||.|
|.||.|||||||.||.|||||||.||.|
|.||.|||||||.||.|||||||.||.|
|..........................|
||||||||||||||||||||||||||||
