
||||||||||||||||||||||||||||
|..........................|
|.|||.||.||||..||||.||.|||.|
|.|||.||.||||..||||.||.|||.|
|.|||.||.||||..||||.||.|||.|
|.|||.||............||.|||.|
|.|||.||.||||||||||.||.|||.|
|.|||.||.||||||||||.||.|||.|
|.|||..................|||.|
|......||||||..||||||......|
|.||||.||||||..||||||.||||.|
|.||||................||||.|
|.||||.||.||||||||.||.||||.|
|......||.||||||||.||......|
|.||||.||.||||||||.||.||||.|
|.||||.||.||||||||.||.||||.|
|.||||.||.||||||||.||.||||.|
|.|||..................|||.|
|.....||.||||||||||.||.....|
|.||||||.||||||||||.||||||.|
|.||||||.||||||||||.||||||.|
|........||||||||||........|
|.|||.||............||.|||.|
|.|||.||.|||.||.|||.||.|||.|
|.....||.|||.||.|||.||.....|
|.|||.||.|||.||.|||.||.|||.|
|.|||.||.|||.||.|||.||.|||.|
|.|||.||.|||.||.|||.||.|||.|
|.|||.||.|||.||.|||.||.|||.|
|..........................|
||||||||||||||||||||||||||||
