
||||||||||||||||||||||||||||
|..........................|
|.|||.||||||||||||||||.|||.|
|.|||.||||||||||||||||.|||.|
|.|||......||||||......|||.|
|.....||||.||||||.||||.....|
|.|||.||||........||||.|||.|
|.|||.||||.||||||.||||.|||.|
|.|||......||||||......|||.|
|.|||..|||.||||||.|||..|||.|
|......|||.||||||.|||......|
|.||||.||..........||.||||.|
|.||||.||.||||||||.||.||||.|
|.||||.||.||||||||.||.||||.|
|.||||....||||||||....||||.|
|.||||.||.||||||||.||.||||.|
|......||.||||||||.||......|
|.||||.||..........||.||||.|
|.||||.||.||.||.||.||.||||.|
|.||||.||.||.||.||.||.||||.|
|.||||.||.||.||.||.||.||||.|
|.||||....||.||.||....||||.|
|......||.||.||.||.||......|
|.||.||||.||.||.||.||||.||.|
|.||.|||............|||.||.|
|.||.|||.||||||||||.|||.||.|
|.||.....||||||||||.....||.|
|.||||||.||||||||||.||||||.|
|.||||||.||||||||||.||||||.|
|..........................|
||||||||||||||||||||||||||||
