
||||||||||||||||||||||||||||
|..........................|
|.||||.|||.||||||.|||.||||.|
|.||||.|||.||||||.|||.||||.|
|.||||.|||.||||||.|||.||||.|
|.||||.......||.......||||.|
|.||||.|||||.||.|||||.||||.|
|......|||||.||.|||||......|
|.||||.|||||....|||||.||||.|
|.||||.|||||.||.|||||.||||.|
|.||||.|||||.||.|||||.||||.|
|.||||................||||.|
|.||||.||.||||||||.||.||||.|
|.||||.||.||||||||.||.||||.|
|.||||.||.||||||||.||.||||.|
|.||||.||.||||||||.||.||||.|
|.........||||||||.........|
|.|||||||..........|||||||.|
|.||||||||.||||||.||||||||.|
|.||....||.||||||.||....||.|
|.||.||.||.||..||.||.||.||.|
|.||.||.||.||..||.||.||.||.|
|.||.||..............||.||.|
|........||||..||||........|
|.||||||.||||..||||.||||||.|
|.||||||.||||..||||.||||||.|
|........||||..||||........|
|.||||||.||||..||||.||||||.|
|.||||||.||||..||||.||||||.|
|..........................|
||||||||||||||||||||||||||||
