
||||||||||||||||||||||||||||
|..........................|
|.|||.||.||||..||||.||.|||.|
|.|||.||.||||..||||.||.|||.|
|.|||.||.||||..||||.||.|||.|
|.|||.||.||||||||||.||.|||.|
|.....||....||||....||.....|
|.||||||.||......||.||||||.|
|.||||||.||||||||||.||||||.|
|.||......||||||||......||.|
|....||||.||||||||.||||....|
|.|||||||..........|||||||.|
|.|||||||.||||||||.|||||||.|
|.........||||||||.........|
|.||||.||.||||||||.||.||||.|
|.||||.||.||||||||.||.||||.|
|.||||.||.||||||||.||.||||.|
|.||||.||..........||.||||.|
|.||||.||||||||||||||.||||.|
|.||||.||||||||||||||.||||.|
|..........................|
|.|||||||.||||||||.|||||||.|
|.|||||||.||||||||.|||||||.|
|.........||||||||.........|
|.||||.||.|||..|||.||.||||.|
|.||||.||..........||.||||.|
|.||||.|||||.||.|||||.||||.|
|.||||.|||||.||.|||||.||||.|
|.||||.|||||.||.|||||.||||.|
|..........................|
||||||||||||||||||||||||||||
