
||||||||||||||||||||||||||||
|..........................|
|.||||||.||||..||||.||||||.|
|.||||||.||||..||||.||||||.|
|.||||||.||||..||||.||||||.|
|.||||||............||||||.|
|........||||||||||........|
|.|||.||.||||||||||.||.|||.|
|.|||.||.....||.....||.|||.|
|.|||..||.||.||.||.||..|||.|
|.|||..||.||.||.||.||..|||.|
|.|||.|||..........|||.|||.|
|.....|||.||||||||.|||.....|
|.|||.|||.||||||||.|||.|||.|
|.|||.|||.||||||||.|||.|||.|
|.||......||||||||......||.|
|.||.||||.||||||||.||||.||.|
|.||.||||..........||||.||.|
|.||.||||.||.||.||.||||.||.|
|.||.||...||.||.||...||.||.|
|.......||||.||.||||.......|
|.||.||.||||.||.||||.||.||.|
|.||.||.||||.||.||||.||.||.|
|.||.||.||||.||.||||.||.||.|
|.||.||..............||.||.|
|.||.|||.||||||||||.|||.||.|
|.||.|||.||||||||||.|||.||.|
|.||.|||.||||||||||.|||.||.|
|.||.|||.||||||||||.|||.||.|
|..........................|
||||||||||||||||||||||||||||
