
||||||||||||||||||||||||||||
|..........................|
|.|||||.||||.||.||||.|||||.|
|.|||||.||||.||.||||.|||||.|
|.|||||......||......|||||.|
|.......||||||||||||.......|
|.||||.||||||||||||||.||||.|
|.||||.||....||....||.||||.|
|.||||....||.||.||....||||.|
|......|||||.||.|||||......|
|.||.|||||||.||.|||||||.||.|
|.||.||||..........||||.||.|
|.||......||||||||......||.|
|.||.||||.||||||||.||||.||.|
|.||.||||.||||||||.||||.||.|
|.||.||||.||||||||.||||.||.|
|....||||.||||||||.||||....|
|.||....................||.|
|.||||||.||||||||||.||||||.|
|.||||||.||||||||||.||||||.|
|..........................|
|.|||||....||||||....|||||.|
|.|||||.||.||||||.||.|||||.|
|.|||||.||.||||||.||.|||||.|
|.......||........||.......|
|.|||||.||.||||||.||.|||||.|
|.|||||.||.||||||.||.|||||.|
|.|||||.||.||||||.||.|||||.|
|.|||||.||.||||||.||.|||||.|
|..........................|
||||||||||||||||||||||||||||
