
||||||||||||||||||||||||||||
|..........................|
|.||||||.||.||||.||.||||||.|
|.||||||.||.||||.||.||||||.|
|.||||||.||.||||.||.||||||.|
|.||||||.||.||||.||.||||||.|
|.|||.......||||.......|||.|
|.....||.||||||||||.||.....|
|.||||||.||||||||||.||||||.|
|.||||||.||||||||||.||||||.|
|........||||||||||........|
|.|||.||............||.|||.|
|.|||.|||.||||||||.|||.|||.|
|.|||.|||.||||||||.|||.|||.|
|.|||.|||.||||||||.|||.|||.|
|.|||.|||.||||||||.|||.|||.|
|.|||.|||.||||||||.|||.|||.|
|......||..........||......|
|.||||....||||||||....||||.|
|.||||.||.||||||||.||.||||.|
|.||||.||.||....||.||.||||.|
|.||...||....||....||...||.|
|.||.||||.||.||.||.||||.||.|
|.||.||||.||.||.||.||||.||.|
|.||.||||.||.||.||.||||.||.|
|.||.||||.||.||.||.||||.||.|
|..........................|
|.|||||||||||..|||||||||||.|
|.|||||||||||..|||||||||||.|
|..........................|
||||||||||||||||||||||||||||
